ccaa_iso;fecha;num_casos;casos_ac;num_casos_prueba_pcr;num_casos_prueba_test_ac;num_casos_prueba_otras;num_casos_prueba_desconocida
AN;2020-01-31;0;0;0;0;0;0
AN;2020-02-01;2;2;2;0;0;0
AN;2020-02-02;2;4;1;1;0;0
AN;2020-02-03;1;5;1;0;0;0
AN;2020-02-04;1;6;0;1;0;0
AN;2020-02-05;1;7;0;1;0;0
AN;2020-02-06;2;9;1;1;0;0
AN;2020-02-07;2;11;2;0;0;0
AN;2020-02-08;0;11;0;0;0;0
AN;2020-02-09;1;12;0;1;0;0
AN;2020-02-10;1;13;1;0;0;0
AN;2020-02-11;1;14;0;1;0;0
AN;2020-02-12;1;15;1;0;0;0
AN;2020-02-13;2;17;1;1;0;0
AN;2020-02-14;1;18;1;0;0;0
AN;2020-02-15;4;22;1;3;0;0
AN;2020-02-16;0;22;0;0;0;0
AN;2020-02-17;2;24;0;2;0;0
AN;2020-02-18;3;27;3;0;0;0
AN;2020-02-19;1;28;0;1;0;0
AN;2020-02-20;8;36;3;5;0;0
AN;2020-02-21;5;41;4;1;0;0
AN;2020-02-22;2;43;2;0;0;0
AN;2020-02-23;2;45;2;0;0;0
AN;2020-02-24;5;50;5;0;0;0
AN;2020-02-25;9;59;9;0;0;0
AN;2020-02-26;9;68;9;0;0;0
AN;2020-02-27;11;79;7;4;0;0
AN;2020-02-28;8;87;7;1;0;0
AN;2020-02-29;9;96;8;1;0;0
AN;2020-03-01;34;130;25;9;0;0
AN;2020-03-02;33;163;31;2;0;0
AN;2020-03-03;42;205;36;6;0;0
AN;2020-03-04;34;239;31;3;0;0
AN;2020-03-05;61;300;55;6;0;0
AN;2020-03-06;73;373;66;7;0;0
AN;2020-03-07;77;450;72;5;0;0
AN;2020-03-08;87;537;78;9;0;0
AN;2020-03-09;169;706;158;11;0;0
AN;2020-03-10;221;927;204;17;0;0
AN;2020-03-11;263;1190;246;17;0;0
AN;2020-03-12;318;1508;301;17;0;0
AN;2020-03-13;487;1995;447;40;0;0
AN;2020-03-14;420;2415;392;28;0;0
AN;2020-03-15;450;2865;409;41;0;0
AN;2020-03-16;573;3438;536;37;0;0
AN;2020-03-17;574;4012;538;36;0;0
AN;2020-03-18;530;4542;493;37;0;0
AN;2020-03-19;556;5098;522;34;0;0
AN;2020-03-20;795;5893;748;47;0;0
AN;2020-03-21;544;6437;517;26;0;1
AN;2020-03-22;523;6960;489;34;0;0
AN;2020-03-23;562;7522;535;27;0;0
AN;2020-03-24;492;8014;463;29;0;0
AN;2020-03-25;522;8536;487;34;0;1
AN;2020-03-26;472;9008;435;36;1;0
AN;2020-03-27;423;9431;392;31;0;0
AN;2020-03-28;324;9755;296;28;0;0
AN;2020-03-29;340;10095;319;21;0;0
AN;2020-03-30;341;10436;302;39;0;0
AN;2020-03-31;254;10690;238;16;0;0
AN;2020-04-01;356;11046;323;32;0;1
AN;2020-04-02;262;11308;215;47;0;0
AN;2020-04-03;202;11510;172;30;0;0
AN;2020-04-04;317;11827;166;151;0;0
AN;2020-04-05;276;12103;159;117;0;0
AN;2020-04-06;187;12290;137;49;0;1
AN;2020-04-07;266;12556;163;103;0;0
AN;2020-04-08;251;12807;132;119;0;0
AN;2020-04-09;137;12944;85;52;0;0
AN;2020-04-10;218;13162;98;120;0;0
AN;2020-04-11;162;13324;94;68;0;0
AN;2020-04-12;129;13453;81;48;0;0
AN;2020-04-13;111;13564;70;40;1;0
AN;2020-04-14;209;13773;57;152;0;0
AN;2020-04-15;216;13989;90;126;0;0
AN;2020-04-16;175;14164;50;125;0;0
AN;2020-04-17;141;14305;63;78;0;0
AN;2020-04-18;135;14440;41;94;0;0
AN;2020-04-19;74;14514;28;46;0;0
AN;2020-04-20;77;14591;37;40;0;0
AN;2020-04-21;154;14745;38;116;0;0
AN;2020-04-22;134;14879;27;107;0;0
AN;2020-04-23;168;15047;35;133;0;0
AN;2020-04-24;169;15216;45;124;0;0
AN;2020-04-25;57;15273;24;33;0;0
AN;2020-04-26;36;15309;15;21;0;0
AN;2020-04-27;46;15355;16;30;0;0
AN;2020-04-28;130;15485;18;112;0;0
AN;2020-04-29;162;15647;32;130;0;0
AN;2020-04-30;119;15766;21;97;1;0
AN;2020-05-01;100;15866;16;84;0;0
AN;2020-05-02;95;15961;15;80;0;0
AN;2020-05-03;27;15988;8;19;0;0
AN;2020-05-04;49;16037;18;31;0;0
AN;2020-05-05;73;16110;12;61;0;0
AN;2020-05-06;26;16136;3;23;0;0
AN;2020-05-07;25;16161;3;21;1;0
AN;2020-05-08;17;16178;8;9;0;0
AN;2020-05-09;14;16192;3;10;0;1
AN;2020-05-10;5;16197;5;0;0;0
AN;2020-05-11;21;16218;17;4;0;0
AN;2020-05-12;21;16239;19;2;0;0
AN;2020-05-13;15;16254;13;2;0;0
AN;2020-05-14;14;16268;10;4;0;0
AN;2020-05-15;14;16282;11;3;0;0
AN;2020-05-16;9;16291;3;5;1;0
AN;2020-05-17;6;16297;5;1;0;0
AN;2020-05-18;11;16308;11;0;0;0
AN;2020-05-19;11;16319;11;0;0;0
AN;2020-05-20;12;16331;12;0;0;0
AN;2020-05-21;9;16340;9;0;0;0
AN;2020-05-22;6;16346;5;1;0;0
AN;2020-05-23;7;16353;7;0;0;0
AN;2020-05-24;3;16356;3;0;0;0
AN;2020-05-25;8;16364;8;0;0;0
AN;2020-05-26;8;16372;8;0;0;0
AN;2020-05-27;11;16383;11;0;0;0
AN;2020-05-28;7;16390;7;0;0;0
AN;2020-05-29;12;16402;12;0;0;0
AN;2020-05-30;13;16415;13;0;0;0
AN;2020-05-31;9;16424;9;0;0;0
AN;2020-06-01;18;16442;18;0;0;0
AN;2020-06-02;6;16448;6;0;0;0
AN;2020-06-03;16;16464;16;0;0;0
AN;2020-06-04;5;16469;5;0;0;0
AN;2020-06-05;12;16481;12;0;0;0
AN;2020-06-06;4;16485;4;0;0;0
AN;2020-06-07;2;16487;2;0;0;0
AN;2020-06-08;6;16493;6;0;0;0
AN;2020-06-09;7;16500;7;0;0;0
AN;2020-06-10;6;16506;6;0;0;0
AN;2020-06-11;3;16509;3;0;0;0
AN;2020-06-12;4;16513;4;0;0;0
AN;2020-06-13;4;16517;4;0;0;0
AN;2020-06-14;3;16520;3;0;0;0
AN;2020-06-15;7;16527;7;0;0;0
AN;2020-06-16;9;16536;9;0;0;0
AN;2020-06-17;10;16546;10;0;0;0
AN;2020-06-18;25;16571;25;0;0;0
AN;2020-06-19;11;16582;11;0;0;0
AN;2020-06-20;15;16597;15;0;0;0
AN;2020-06-21;10;16607;10;0;0;0
AN;2020-06-22;16;16623;16;0;0;0
AN;2020-06-23;13;16636;13;0;0;0
AN;2020-06-24;95;16731;95;0;0;0
AN;2020-06-25;22;16753;22;0;0;0
AN;2020-06-26;19;16772;19;0;0;0
AN;2020-06-27;15;16787;15;0;0;0
AN;2020-06-28;27;16814;27;0;0;0
AN;2020-06-29;22;16836;22;0;0;0
AN;2020-06-30;26;16862;25;0;1;0
AN;2020-07-01;22;16884;22;0;0;0
AN;2020-07-02;14;16898;14;0;0;0
AN;2020-07-03;25;16923;25;0;0;0
AN;2020-07-04;25;16948;25;0;0;0
AN;2020-07-05;16;16964;16;0;0;0
AN;2020-07-06;22;16986;22;0;0;0
AN;2020-07-07;30;17016;30;0;0;0
AN;2020-07-08;55;17071;55;0;0;0
AN;2020-07-09;36;17107;36;0;0;0
AN;2020-07-10;59;17166;59;0;0;0
AN;2020-07-11;49;17215;49;0;0;0
AN;2020-07-12;32;17247;32;0;0;0
AN;2020-07-13;47;17294;47;0;0;0
AN;2020-07-14;95;17389;95;0;0;0
AN;2020-07-15;64;17453;64;0;0;0
AN;2020-07-16;74;17527;74;0;0;0
AN;2020-07-17;94;17621;94;0;0;0
AN;2020-07-18;87;17708;87;0;0;0
AN;2020-07-19;114;17822;114;0;0;0
AN;2020-07-20;118;17940;118;0;0;0
AN;2020-07-21;74;18014;74;0;0;0
AN;2020-07-22;78;18092;78;0;0;0
AN;2020-07-23;112;18204;112;0;0;0
AN;2020-07-24;126;18330;126;0;0;0
AN;2020-07-25;108;18438;108;0;0;0
AN;2020-07-26;99;18537;99;0;0;0
AN;2020-07-27;132;18669;132;0;0;0
AN;2020-07-28;139;18808;139;0;0;0
AN;2020-07-29;144;18952;144;0;0;0
AN;2020-07-30;206;19158;206;0;0;0
AN;2020-07-31;252;19410;252;0;0;0
AN;2020-08-01;220;19630;220;0;0;0
AN;2020-08-02;209;19839;209;0;0;0
AN;2020-08-03;245;20084;245;0;0;0
AN;2020-08-04;249;20333;249;0;0;0
AN;2020-08-05;328;20661;328;0;0;0
AN;2020-08-06;342;21003;342;0;0;0
AN;2020-08-07;397;21400;397;0;0;0
AN;2020-08-08;361;21761;361;0;0;0
AN;2020-08-09;275;22036;275;0;0;0
AN;2020-08-10;366;22402;366;0;0;0
AN;2020-08-11;385;22787;385;0;0;0
AN;2020-08-12;403;23190;403;0;0;0
AN;2020-08-13;431;23621;431;0;0;0
AN;2020-08-14;470;24091;470;0;0;0
AN;2020-08-15;414;24505;414;0;0;0
AN;2020-08-16;269;24774;269;0;0;0
AR;2020-01-31;0;0;0;0;0;0
AR;2020-02-01;0;0;0;0;0;0
AR;2020-02-02;0;0;0;0;0;0
AR;2020-02-03;0;0;0;0;0;0
AR;2020-02-04;0;0;0;0;0;0
AR;2020-02-05;0;0;0;0;0;0
AR;2020-02-06;1;1;1;0;0;0
AR;2020-02-07;0;1;0;0;0;0
AR;2020-02-08;0;1;0;0;0;0
AR;2020-02-09;0;1;0;0;0;0
AR;2020-02-10;0;1;0;0;0;0
AR;2020-02-11;1;2;1;0;0;0
AR;2020-02-12;0;2;0;0;0;0
AR;2020-02-13;1;3;1;0;0;0
AR;2020-02-14;0;3;0;0;0;0
AR;2020-02-15;0;3;0;0;0;0
AR;2020-02-16;1;4;1;0;0;0
AR;2020-02-17;1;5;1;0;0;0
AR;2020-02-18;1;6;1;0;0;0
AR;2020-02-19;0;6;0;0;0;0
AR;2020-02-20;0;6;0;0;0;0
AR;2020-02-21;2;8;2;0;0;0
AR;2020-02-22;3;11;3;0;0;0
AR;2020-02-23;1;12;1;0;0;0
AR;2020-02-24;1;13;1;0;0;0
AR;2020-02-25;2;15;2;0;0;0
AR;2020-02-26;2;17;2;0;0;0
AR;2020-02-27;0;17;0;0;0;0
AR;2020-02-28;3;20;3;0;0;0
AR;2020-02-29;6;26;6;0;0;0
AR;2020-03-01;8;34;8;0;0;0
AR;2020-03-02;14;48;14;0;0;0
AR;2020-03-03;8;56;8;0;0;0
AR;2020-03-04;14;70;14;0;0;0
AR;2020-03-05;11;81;11;0;0;0
AR;2020-03-06;15;96;15;0;0;0
AR;2020-03-07;22;118;22;0;0;0
AR;2020-03-08;36;154;35;0;0;1
AR;2020-03-09;36;190;36;0;0;0
AR;2020-03-10;52;242;52;0;0;0
AR;2020-03-11;66;308;66;0;0;0
AR;2020-03-12;80;388;80;0;0;0
AR;2020-03-13;115;503;115;0;0;0
AR;2020-03-14;107;610;107;0;0;0
AR;2020-03-15;127;737;127;0;0;0
AR;2020-03-16;163;900;163;0;0;0
AR;2020-03-17;158;1058;157;0;1;0
AR;2020-03-18;168;1226;168;0;0;0
AR;2020-03-19;168;1394;168;0;0;0
AR;2020-03-20;241;1635;241;0;0;0
AR;2020-03-21;177;1812;177;0;0;0
AR;2020-03-22;164;1976;164;0;0;0
AR;2020-03-23;265;2241;265;0;0;0
AR;2020-03-24;192;2433;192;0;0;0
AR;2020-03-25;189;2622;188;0;0;1
AR;2020-03-26;166;2788;166;0;0;0
AR;2020-03-27;213;3001;212;0;0;1
AR;2020-03-28;147;3148;147;0;0;0
AR;2020-03-29;136;3284;136;0;0;0
AR;2020-03-30;131;3415;131;0;0;0
AR;2020-03-31;116;3531;116;0;0;0
AR;2020-04-01;157;3688;156;0;0;1
AR;2020-04-02;127;3815;127;0;0;0
AR;2020-04-03;108;3923;108;0;0;0
AR;2020-04-04;94;4017;93;0;0;1
AR;2020-04-05;95;4112;94;0;1;0
AR;2020-04-06;125;4237;125;0;0;0
AR;2020-04-07;108;4345;108;0;0;0
AR;2020-04-08;111;4456;110;0;0;1
AR;2020-04-09;102;4558;89;0;0;13
AR;2020-04-10;83;4641;73;0;1;9
AR;2020-04-11;63;4704;57;0;0;6
AR;2020-04-12;54;4758;51;0;0;3
AR;2020-04-13;83;4841;71;0;0;12
AR;2020-04-14;53;4894;44;0;0;9
AR;2020-04-15;79;4973;64;0;0;15
AR;2020-04-16;63;5036;55;0;0;8
AR;2020-04-17;69;5105;53;0;0;16
AR;2020-04-18;57;5162;55;0;0;2
AR;2020-04-19;44;5206;35;0;0;9
AR;2020-04-20;45;5251;30;0;0;15
AR;2020-04-21;132;5383;37;0;0;95
AR;2020-04-22;100;5483;57;0;0;43
AR;2020-04-23;27;5510;21;0;0;6
AR;2020-04-24;25;5535;21;0;0;4
AR;2020-04-25;33;5568;19;0;0;14
AR;2020-04-26;21;5589;16;0;0;5
AR;2020-04-27;66;5655;24;0;1;41
AR;2020-04-28;127;5782;29;0;1;97
AR;2020-04-29;39;5821;23;0;0;16
AR;2020-04-30;39;5860;26;0;0;13
AR;2020-05-01;15;5875;15;0;0;0
AR;2020-05-02;19;5894;15;0;1;3
AR;2020-05-03;18;5912;16;0;2;0
AR;2020-05-04;33;5945;33;0;0;0
AR;2020-05-05;43;5988;6;0;0;37
AR;2020-05-06;43;6031;6;0;1;36
AR;2020-05-07;22;6053;18;0;0;4
AR;2020-05-08;13;6066;11;0;0;2
AR;2020-05-09;4;6070;4;0;0;0
AR;2020-05-10;8;6078;7;0;0;1
AR;2020-05-11;6;6084;5;0;1;0
AR;2020-05-12;17;6101;17;0;0;0
AR;2020-05-13;21;6122;21;0;0;0
AR;2020-05-14;25;6147;25;0;0;0
AR;2020-05-15;15;6162;15;0;0;0
AR;2020-05-16;7;6169;7;0;0;0
AR;2020-05-17;8;6177;8;0;0;0
AR;2020-05-18;19;6196;17;0;0;2
AR;2020-05-19;23;6219;23;0;0;0
AR;2020-05-20;14;6233;13;0;1;0
AR;2020-05-21;11;6244;11;0;0;0
AR;2020-05-22;13;6257;13;0;0;0
AR;2020-05-23;11;6268;11;0;0;0
AR;2020-05-24;5;6273;5;0;0;0
AR;2020-05-25;12;6285;12;0;0;0
AR;2020-05-26;12;6297;12;0;0;0
AR;2020-05-27;14;6311;14;0;0;0
AR;2020-05-28;9;6320;9;0;0;0
AR;2020-05-29;12;6332;11;0;0;1
AR;2020-05-30;5;6337;5;0;0;0
AR;2020-05-31;8;6345;8;0;0;0
AR;2020-06-01;9;6354;8;0;0;1
AR;2020-06-02;17;6371;17;0;0;0
AR;2020-06-03;7;6378;7;0;0;0
AR;2020-06-04;10;6388;10;0;0;0
AR;2020-06-05;6;6394;6;0;0;0
AR;2020-06-06;6;6400;6;0;0;0
AR;2020-06-07;5;6405;5;0;0;0
AR;2020-06-08;6;6411;6;0;0;0
AR;2020-06-09;12;6423;12;0;0;0
AR;2020-06-10;2;6425;2;0;0;0
AR;2020-06-11;6;6431;6;0;0;0
AR;2020-06-12;4;6435;4;0;0;0
AR;2020-06-13;4;6439;3;0;0;1
AR;2020-06-14;3;6442;2;0;1;0
AR;2020-06-15;7;6449;7;0;0;0
AR;2020-06-16;11;6460;11;0;0;0
AR;2020-06-17;7;6467;7;0;0;0
AR;2020-06-18;18;6485;18;0;0;0
AR;2020-06-19;25;6510;25;0;0;0
AR;2020-06-20;29;6539;29;0;0;0
AR;2020-06-21;42;6581;40;0;1;1
AR;2020-06-22;58;6639;58;0;0;0
AR;2020-06-23;48;6687;48;0;0;0
AR;2020-06-24;64;6751;62;0;1;1
AR;2020-06-25;48;6799;47;0;0;1
AR;2020-06-26;22;6821;22;0;0;0
AR;2020-06-27;54;6875;53;0;1;0
AR;2020-06-28;18;6893;17;0;0;1
AR;2020-06-29;25;6918;24;0;0;1
AR;2020-06-30;37;6955;37;0;0;0
AR;2020-07-01;36;6991;36;0;0;0
AR;2020-07-02;23;7014;23;0;0;0
AR;2020-07-03;44;7058;44;0;0;0
AR;2020-07-04;33;7091;32;0;0;1
AR;2020-07-05;37;7128;37;0;0;0
AR;2020-07-06;75;7203;75;0;0;0
AR;2020-07-07;90;7293;88;0;0;2
AR;2020-07-08;77;7370;76;0;0;1
AR;2020-07-09;85;7455;85;0;0;0
AR;2020-07-10;127;7582;126;0;0;1
AR;2020-07-11;154;7736;154;0;0;0
AR;2020-07-12;128;7864;128;0;0;0
AR;2020-07-13;225;8089;225;0;0;0
AR;2020-07-14;291;8380;290;0;0;1
AR;2020-07-15;360;8740;357;0;1;2
AR;2020-07-16;295;9035;294;0;0;1
AR;2020-07-17;400;9435;395;0;0;5
AR;2020-07-18;344;9779;340;0;0;4
AR;2020-07-19;335;10114;334;0;0;1
AR;2020-07-20;428;10542;422;0;0;6
AR;2020-07-21;458;11000;455;0;0;3
AR;2020-07-22;469;11469;462;0;0;7
AR;2020-07-23;389;11858;383;0;0;6
AR;2020-07-24;453;12311;440;0;0;13
AR;2020-07-25;390;12701;390;0;0;0
AR;2020-07-26;397;13098;394;0;0;3
AR;2020-07-27;584;13682;578;0;0;6
AR;2020-07-28;531;14213;529;0;0;2
AR;2020-07-29;556;14769;553;0;0;3
AR;2020-07-30;500;15269;495;0;0;5
AR;2020-07-31;506;15775;504;0;0;2
AR;2020-08-01;839;16614;836;0;0;3
AR;2020-08-02;442;17056;439;0;0;3
AR;2020-08-03;449;17505;446;0;0;3
AR;2020-08-04;522;18027;516;0;0;6
AR;2020-08-05;421;18448;413;0;0;8
AR;2020-08-06;501;18949;496;0;0;5
AR;2020-08-07;546;19495;540;0;0;6
AR;2020-08-08;495;19990;491;0;0;4
AR;2020-08-09;290;20280;277;0;0;13
AR;2020-08-10;532;20812;521;0;1;10
AR;2020-08-11;342;21154;330;0;0;12
AR;2020-08-12;417;21571;400;0;0;17
AR;2020-08-13;401;21972;372;0;0;29
AR;2020-08-14;372;22344;345;0;1;26
AR;2020-08-15;278;22622;250;0;0;28
AR;2020-08-16;247;22869;226;0;0;21
AS;2020-01-31;0;0;0;0;0;0
AS;2020-02-01;0;0;0;0;0;0
AS;2020-02-02;0;0;0;0;0;0
AS;2020-02-03;0;0;0;0;0;0
AS;2020-02-04;0;0;0;0;0;0
AS;2020-02-05;0;0;0;0;0;0
AS;2020-02-06;0;0;0;0;0;0
AS;2020-02-07;0;0;0;0;0;0
AS;2020-02-08;0;0;0;0;0;0
AS;2020-02-09;0;0;0;0;0;0
AS;2020-02-10;0;0;0;0;0;0
AS;2020-02-11;0;0;0;0;0;0
AS;2020-02-12;0;0;0;0;0;0
AS;2020-02-13;0;0;0;0;0;0
AS;2020-02-14;0;0;0;0;0;0
AS;2020-02-15;0;0;0;0;0;0
AS;2020-02-16;0;0;0;0;0;0
AS;2020-02-17;0;0;0;0;0;0
AS;2020-02-18;0;0;0;0;0;0
AS;2020-02-19;0;0;0;0;0;0
AS;2020-02-20;0;0;0;0;0;0
AS;2020-02-21;0;0;0;0;0;0
AS;2020-02-22;0;0;0;0;0;0
AS;2020-02-23;1;1;1;0;0;0
AS;2020-02-24;0;1;0;0;0;0
AS;2020-02-25;1;2;1;0;0;0
AS;2020-02-26;0;2;0;0;0;0
AS;2020-02-27;0;2;0;0;0;0
AS;2020-02-28;1;3;1;0;0;0
AS;2020-02-29;2;5;2;0;0;0
AS;2020-03-01;2;7;2;0;0;0
AS;2020-03-02;3;10;3;0;0;0
AS;2020-03-03;2;12;2;0;0;0
AS;2020-03-04;2;14;2;0;0;0
AS;2020-03-05;5;19;5;0;0;0
AS;2020-03-06;12;31;12;0;0;0
AS;2020-03-07;12;43;12;0;0;0
AS;2020-03-08;14;57;14;0;0;0
AS;2020-03-09;32;89;32;0;0;0
AS;2020-03-10;52;141;52;0;0;0
AS;2020-03-11;43;184;43;0;0;0
AS;2020-03-12;57;241;57;0;0;0
AS;2020-03-13;70;311;70;0;0;0
AS;2020-03-14;81;392;81;0;0;0
AS;2020-03-15;89;481;89;0;0;0
AS;2020-03-16;106;587;106;0;0;0
AS;2020-03-17;80;667;80;0;0;0
AS;2020-03-18;91;758;91;0;0;0
AS;2020-03-19;101;859;101;0;0;0
AS;2020-03-20;83;942;83;0;0;0
AS;2020-03-21;68;1010;68;0;0;0
AS;2020-03-22;75;1085;75;0;0;0
AS;2020-03-23;70;1155;70;0;0;0
AS;2020-03-24;58;1213;58;0;0;0
AS;2020-03-25;57;1270;57;0;0;0
AS;2020-03-26;77;1347;77;0;0;0
AS;2020-03-27;70;1417;70;0;0;0
AS;2020-03-28;53;1470;53;0;0;0
AS;2020-03-29;40;1510;40;0;0;0
AS;2020-03-30;45;1555;45;0;0;0
AS;2020-03-31;42;1597;42;0;0;0
AS;2020-04-01;29;1626;29;0;0;0
AS;2020-04-02;54;1680;54;0;0;0
AS;2020-04-03;38;1718;38;0;0;0
AS;2020-04-04;45;1763;45;0;0;0
AS;2020-04-05;43;1806;43;0;0;0
AS;2020-04-06;41;1847;41;0;0;0
AS;2020-04-07;45;1892;45;0;0;0
AS;2020-04-08;48;1940;48;0;0;0
AS;2020-04-09;43;1983;43;0;0;0
AS;2020-04-10;57;2040;57;0;0;0
AS;2020-04-11;53;2093;53;0;0;0
AS;2020-04-12;23;2116;23;0;0;0
AS;2020-04-13;32;2148;32;0;0;0
AS;2020-04-14;30;2178;30;0;0;0
AS;2020-04-15;40;2218;40;0;0;0
AS;2020-04-16;12;2230;12;0;0;0
AS;2020-04-17;12;2242;12;0;0;0
AS;2020-04-18;9;2251;9;0;0;0
AS;2020-04-19;6;2257;6;0;0;0
AS;2020-04-20;7;2264;7;0;0;0
AS;2020-04-21;16;2280;16;0;0;0
AS;2020-04-22;8;2288;8;0;0;0
AS;2020-04-23;9;2297;9;0;0;0
AS;2020-04-24;17;2314;17;0;0;0
AS;2020-04-25;3;2317;3;0;0;0
AS;2020-04-26;5;2322;5;0;0;0
AS;2020-04-27;5;2327;5;0;0;0
AS;2020-04-28;10;2337;10;0;0;0
AS;2020-04-29;3;2340;3;0;0;0
AS;2020-04-30;10;2350;10;0;0;0
AS;2020-05-01;2;2352;2;0;0;0
AS;2020-05-02;3;2355;3;0;0;0
AS;2020-05-03;3;2358;3;0;0;0
AS;2020-05-04;4;2362;4;0;0;0
AS;2020-05-05;4;2366;4;0;0;0
AS;2020-05-06;4;2370;4;0;0;0
AS;2020-05-07;3;2373;3;0;0;0
AS;2020-05-08;3;2376;3;0;0;0
AS;2020-05-09;2;2378;2;0;0;0
AS;2020-05-10;1;2379;1;0;0;0
AS;2020-05-11;5;2384;5;0;0;0
AS;2020-05-12;0;2384;0;0;0;0
AS;2020-05-13;2;2386;2;0;0;0
AS;2020-05-14;2;2388;2;0;0;0
AS;2020-05-15;4;2392;4;0;0;0
AS;2020-05-16;1;2393;1;0;0;0
AS;2020-05-17;4;2397;4;0;0;0
AS;2020-05-18;0;2397;0;0;0;0
AS;2020-05-19;0;2397;0;0;0;0
AS;2020-05-20;1;2398;1;0;0;0
AS;2020-05-21;1;2399;1;0;0;0
AS;2020-05-22;1;2400;1;0;0;0
AS;2020-05-23;1;2401;1;0;0;0
AS;2020-05-24;2;2403;2;0;0;0
AS;2020-05-25;1;2404;1;0;0;0
AS;2020-05-26;2;2406;2;0;0;0
AS;2020-05-27;0;2406;0;0;0;0
AS;2020-05-28;0;2406;0;0;0;0
AS;2020-05-29;14;2420;14;0;0;0
AS;2020-05-30;4;2424;4;0;0;0
AS;2020-05-31;3;2427;3;0;0;0
AS;2020-06-01;0;2427;0;0;0;0
AS;2020-06-02;0;2427;0;0;0;0
AS;2020-06-03;0;2427;0;0;0;0
AS;2020-06-04;0;2427;0;0;0;0
AS;2020-06-05;2;2429;2;0;0;0
AS;2020-06-06;2;2431;2;0;0;0
AS;2020-06-07;1;2432;1;0;0;0
AS;2020-06-08;0;2432;0;0;0;0
AS;2020-06-09;0;2432;0;0;0;0
AS;2020-06-10;0;2432;0;0;0;0
AS;2020-06-11;3;2435;3;0;0;0
AS;2020-06-12;0;2435;0;0;0;0
AS;2020-06-13;0;2435;0;0;0;0
AS;2020-06-14;0;2435;0;0;0;0
AS;2020-06-15;0;2435;0;0;0;0
AS;2020-06-16;0;2435;0;0;0;0
AS;2020-06-17;0;2435;0;0;0;0
AS;2020-06-18;0;2435;0;0;0;0
AS;2020-06-19;0;2435;0;0;0;0
AS;2020-06-20;0;2435;0;0;0;0
AS;2020-06-21;0;2435;0;0;0;0
AS;2020-06-22;0;2435;0;0;0;0
AS;2020-06-23;0;2435;0;0;0;0
AS;2020-06-24;0;2435;0;0;0;0
AS;2020-06-25;0;2435;0;0;0;0
AS;2020-06-26;0;2435;0;0;0;0
AS;2020-06-27;0;2435;0;0;0;0
AS;2020-06-28;0;2435;0;0;0;0
AS;2020-06-29;1;2436;1;0;0;0
AS;2020-06-30;0;2436;0;0;0;0
AS;2020-07-01;1;2437;1;0;0;0
AS;2020-07-02;0;2437;0;0;0;0
AS;2020-07-03;0;2437;0;0;0;0
AS;2020-07-04;0;2437;0;0;0;0
AS;2020-07-05;0;2437;0;0;0;0
AS;2020-07-06;0;2437;0;0;0;0
AS;2020-07-07;0;2437;0;0;0;0
AS;2020-07-08;2;2439;2;0;0;0
AS;2020-07-09;0;2439;0;0;0;0
AS;2020-07-10;2;2441;2;0;0;0
AS;2020-07-11;3;2444;3;0;0;0
AS;2020-07-12;0;2444;0;0;0;0
AS;2020-07-13;0;2444;0;0;0;0
AS;2020-07-14;2;2446;2;0;0;0
AS;2020-07-15;2;2448;2;0;0;0
AS;2020-07-16;1;2449;1;0;0;0
AS;2020-07-17;1;2450;1;0;0;0
AS;2020-07-18;1;2451;1;0;0;0
AS;2020-07-19;2;2453;2;0;0;0
AS;2020-07-20;1;2454;1;0;0;0
AS;2020-07-21;2;2456;2;0;0;0
AS;2020-07-22;2;2458;2;0;0;0
AS;2020-07-23;3;2461;3;0;0;0
AS;2020-07-24;4;2465;4;0;0;0
AS;2020-07-25;7;2472;7;0;0;0
AS;2020-07-26;7;2479;7;0;0;0
AS;2020-07-27;11;2490;11;0;0;0
AS;2020-07-28;11;2501;11;0;0;0
AS;2020-07-29;13;2514;13;0;0;0
AS;2020-07-30;11;2525;11;0;0;0
AS;2020-07-31;12;2537;12;0;0;0
AS;2020-08-01;17;2554;17;0;0;0
AS;2020-08-02;11;2565;11;0;0;0
AS;2020-08-03;11;2576;11;0;0;0
AS;2020-08-04;15;2591;15;0;0;0
AS;2020-08-05;42;2633;42;0;0;0
AS;2020-08-06;38;2671;38;0;0;0
AS;2020-08-07;31;2702;31;0;0;0
AS;2020-08-08;22;2724;22;0;0;0
AS;2020-08-09;19;2743;19;0;0;0
AS;2020-08-10;15;2758;15;0;0;0
AS;2020-08-11;26;2784;26;0;0;0
AS;2020-08-12;45;2829;45;0;0;0
AS;2020-08-13;26;2855;26;0;0;0
AS;2020-08-14;19;2874;19;0;0;0
AS;2020-08-15;21;2895;21;0;0;0
AS;2020-08-16;22;2917;22;0;0;0
CB;2020-01-31;0;0;0;0;0;0
CB;2020-02-01;0;0;0;0;0;0
CB;2020-02-02;0;0;0;0;0;0
CB;2020-02-03;0;0;0;0;0;0
CB;2020-02-04;0;0;0;0;0;0
CB;2020-02-05;0;0;0;0;0;0
CB;2020-02-06;0;0;0;0;0;0
CB;2020-02-07;0;0;0;0;0;0
CB;2020-02-08;0;0;0;0;0;0
CB;2020-02-09;0;0;0;0;0;0
CB;2020-02-10;0;0;0;0;0;0
CB;2020-02-11;0;0;0;0;0;0
CB;2020-02-12;0;0;0;0;0;0
CB;2020-02-13;0;0;0;0;0;0
CB;2020-02-14;0;0;0;0;0;0
CB;2020-02-15;0;0;0;0;0;0
CB;2020-02-16;0;0;0;0;0;0
CB;2020-02-17;0;0;0;0;0;0
CB;2020-02-18;0;0;0;0;0;0
CB;2020-02-19;0;0;0;0;0;0
CB;2020-02-20;0;0;0;0;0;0
CB;2020-02-21;0;0;0;0;0;0
CB;2020-02-22;0;0;0;0;0;0
CB;2020-02-23;1;1;1;0;0;0
CB;2020-02-24;0;1;0;0;0;0
CB;2020-02-25;8;9;8;0;0;0
CB;2020-02-26;0;9;0;0;0;0
CB;2020-02-27;0;9;0;0;0;0
CB;2020-02-28;0;9;0;0;0;0
CB;2020-02-29;1;10;1;0;0;0
CB;2020-03-01;1;11;1;0;0;0
CB;2020-03-02;0;11;0;0;0;0
CB;2020-03-03;0;11;0;0;0;0
CB;2020-03-04;0;11;0;0;0;0
CB;2020-03-05;0;11;0;0;0;0
CB;2020-03-06;9;20;9;0;0;0
CB;2020-03-07;12;32;12;0;0;0
CB;2020-03-08;17;49;17;0;0;0
CB;2020-03-09;9;58;9;0;0;0
CB;2020-03-10;3;61;3;0;0;0
CB;2020-03-11;17;78;17;0;0;0
CB;2020-03-12;36;114;36;0;0;0
CB;2020-03-13;54;168;54;0;0;0
CB;2020-03-14;59;227;59;0;0;0
CB;2020-03-15;68;295;68;0;0;0
CB;2020-03-16;71;366;71;0;0;0
CB;2020-03-17;76;442;76;0;0;0
CB;2020-03-18;89;531;89;0;0;0
CB;2020-03-19;177;708;177;0;0;0
CB;2020-03-20;143;851;143;0;0;0
CB;2020-03-21;99;950;99;0;0;0
CB;2020-03-22;84;1034;84;0;0;0
CB;2020-03-23;87;1121;87;0;0;0
CB;2020-03-24;57;1178;57;0;0;0
CB;2020-03-25;57;1235;57;0;0;0
CB;2020-03-26;39;1274;39;0;0;0
CB;2020-03-27;74;1348;74;0;0;0
CB;2020-03-28;68;1416;68;0;0;0
CB;2020-03-29;39;1455;39;0;0;0
CB;2020-03-30;27;1482;27;0;0;0
CB;2020-03-31;33;1515;33;0;0;0
CB;2020-04-01;72;1587;72;0;0;0
CB;2020-04-02;53;1640;53;0;0;0
CB;2020-04-03;34;1674;34;0;0;0
CB;2020-04-04;62;1736;62;0;0;0
CB;2020-04-05;25;1761;25;0;0;0
CB;2020-04-06;28;1789;27;1;0;0
CB;2020-04-07;13;1802;13;0;0;0
CB;2020-04-08;26;1828;26;0;0;0
CB;2020-04-09;23;1851;23;0;0;0
CB;2020-04-10;29;1880;29;0;0;0
CB;2020-04-11;24;1904;24;0;0;0
CB;2020-04-12;46;1950;46;0;0;0
CB;2020-04-13;35;1985;35;0;0;0
CB;2020-04-14;14;1999;14;0;0;0
CB;2020-04-15;17;2016;17;0;0;0
CB;2020-04-16;18;2034;18;0;0;0
CB;2020-04-17;27;2061;26;0;0;1
CB;2020-04-18;13;2074;13;0;0;0
CB;2020-04-19;15;2089;15;0;0;0
CB;2020-04-20;24;2113;24;0;0;0
CB;2020-04-21;10;2123;10;0;0;0
CB;2020-04-22;26;2149;26;0;0;0
CB;2020-04-23;26;2175;26;0;0;0
CB;2020-04-24;13;2188;13;0;0;0
CB;2020-04-25;12;2200;12;0;0;0
CB;2020-04-26;4;2204;4;0;0;0
CB;2020-04-27;2;2206;2;0;0;0
CB;2020-04-28;5;2211;5;0;0;0
CB;2020-04-29;5;2216;5;0;0;0
CB;2020-04-30;12;2228;12;0;0;0
CB;2020-05-01;16;2244;16;0;0;0
CB;2020-05-02;0;2244;0;0;0;0
CB;2020-05-03;3;2247;3;0;0;0
CB;2020-05-04;1;2248;1;0;0;0
CB;2020-05-05;6;2254;6;0;0;0
CB;2020-05-06;0;2254;0;0;0;0
CB;2020-05-07;0;2254;0;0;0;0
CB;2020-05-08;2;2256;2;0;0;0
CB;2020-05-09;1;2257;1;0;0;0
CB;2020-05-10;2;2259;1;1;0;0
CB;2020-05-11;7;2266;6;1;0;0
CB;2020-05-12;7;2273;6;1;0;0
CB;2020-05-13;2;2275;2;0;0;0
CB;2020-05-14;2;2277;2;0;0;0
CB;2020-05-15;2;2279;2;0;0;0
CB;2020-05-16;4;2283;4;0;0;0
CB;2020-05-17;0;2283;0;0;0;0
CB;2020-05-18;2;2285;2;0;0;0
CB;2020-05-19;2;2287;2;0;0;0
CB;2020-05-20;0;2287;0;0;0;0
CB;2020-05-21;3;2290;3;0;0;0
CB;2020-05-22;1;2291;1;0;0;0
CB;2020-05-23;2;2293;2;0;0;0
CB;2020-05-24;0;2293;0;0;0;0
CB;2020-05-25;1;2294;1;0;0;0
CB;2020-05-26;4;2298;4;0;0;0
CB;2020-05-27;2;2300;2;0;0;0
CB;2020-05-28;1;2301;1;0;0;0
CB;2020-05-29;3;2304;3;0;0;0
CB;2020-05-30;2;2306;2;0;0;0
CB;2020-05-31;1;2307;1;0;0;0
CB;2020-06-01;4;2311;4;0;0;0
CB;2020-06-02;2;2313;2;0;0;0
CB;2020-06-03;0;2313;0;0;0;0
CB;2020-06-04;1;2314;1;0;0;0
CB;2020-06-05;2;2316;2;0;0;0
CB;2020-06-06;0;2316;0;0;0;0
CB;2020-06-07;3;2319;3;0;0;0
CB;2020-06-08;1;2320;1;0;0;0
CB;2020-06-09;0;2320;0;0;0;0
CB;2020-06-10;1;2321;0;1;0;0
CB;2020-06-11;3;2324;3;0;0;0
CB;2020-06-12;2;2326;2;0;0;0
CB;2020-06-13;1;2327;1;0;0;0
CB;2020-06-14;2;2329;2;0;0;0
CB;2020-06-15;1;2330;1;0;0;0
CB;2020-06-16;2;2332;2;0;0;0
CB;2020-06-17;3;2335;3;0;0;0
CB;2020-06-18;5;2340;5;0;0;0
CB;2020-06-19;0;2340;0;0;0;0
CB;2020-06-20;3;2343;3;0;0;0
CB;2020-06-21;2;2345;2;0;0;0
CB;2020-06-22;1;2346;1;0;0;0
CB;2020-06-23;2;2348;2;0;0;0
CB;2020-06-24;2;2350;2;0;0;0
CB;2020-06-25;0;2350;0;0;0;0
CB;2020-06-26;3;2353;3;0;0;0
CB;2020-06-27;2;2355;2;0;0;0
CB;2020-06-28;0;2355;0;0;0;0
CB;2020-06-29;0;2355;0;0;0;0
CB;2020-06-30;1;2356;1;0;0;0
CB;2020-07-01;1;2357;1;0;0;0
CB;2020-07-02;0;2357;0;0;0;0
CB;2020-07-03;3;2360;3;0;0;0
CB;2020-07-04;0;2360;0;0;0;0
CB;2020-07-05;2;2362;2;0;0;0
CB;2020-07-06;0;2362;0;0;0;0
CB;2020-07-07;1;2363;1;0;0;0
CB;2020-07-08;2;2365;2;0;0;0
CB;2020-07-09;1;2366;1;0;0;0
CB;2020-07-10;1;2367;1;0;0;0
CB;2020-07-11;1;2368;1;0;0;0
CB;2020-07-12;2;2370;2;0;0;0
CB;2020-07-13;1;2371;1;0;0;0
CB;2020-07-14;2;2373;2;0;0;0
CB;2020-07-15;4;2377;4;0;0;0
CB;2020-07-16;5;2382;5;0;0;0
CB;2020-07-17;3;2385;3;0;0;0
CB;2020-07-18;12;2397;12;0;0;0
CB;2020-07-19;5;2402;5;0;0;0
CB;2020-07-20;9;2411;9;0;0;0
CB;2020-07-21;5;2416;5;0;0;0
CB;2020-07-22;6;2422;6;0;0;0
CB;2020-07-23;8;2430;8;0;0;0
CB;2020-07-24;6;2436;6;0;0;0
CB;2020-07-25;9;2445;9;0;0;0
CB;2020-07-26;7;2452;7;0;0;0
CB;2020-07-27;6;2458;6;0;0;0
CB;2020-07-28;7;2465;7;0;0;0
CB;2020-07-29;9;2474;9;0;0;0
CB;2020-07-30;26;2500;26;0;0;0
CB;2020-07-31;16;2516;16;0;0;0
CB;2020-08-01;35;2551;34;0;0;1
CB;2020-08-02;22;2573;22;0;0;0
CB;2020-08-03;40;2613;40;0;0;0
CB;2020-08-04;48;2661;48;0;0;0
CB;2020-08-05;30;2691;30;0;0;0
CB;2020-08-06;45;2736;45;0;0;0
CB;2020-08-07;43;2779;43;0;0;0
CB;2020-08-08;42;2821;42;0;0;0
CB;2020-08-09;27;2848;27;0;0;0
CB;2020-08-10;39;2887;39;0;0;0
CB;2020-08-11;73;2960;73;0;0;0
CB;2020-08-12;45;3005;45;0;0;0
CB;2020-08-13;40;3045;40;0;0;0
CB;2020-08-14;49;3094;49;0;0;0
CB;2020-08-15;34;3128;34;0;0;0
CB;2020-08-16;40;3168;40;0;0;0
CE;2020-01-31;0;0;0;0;0;0
CE;2020-02-01;0;0;0;0;0;0
CE;2020-02-02;0;0;0;0;0;0
CE;2020-02-03;0;0;0;0;0;0
CE;2020-02-04;0;0;0;0;0;0
CE;2020-02-05;1;1;0;1;0;0
CE;2020-02-06;0;1;0;0;0;0
CE;2020-02-07;0;1;0;0;0;0
CE;2020-02-08;0;1;0;0;0;0
CE;2020-02-09;0;1;0;0;0;0
CE;2020-02-10;0;1;0;0;0;0
CE;2020-02-11;0;1;0;0;0;0
CE;2020-02-12;0;1;0;0;0;0
CE;2020-02-13;1;2;0;1;0;0
CE;2020-02-14;0;2;0;0;0;0
CE;2020-02-15;0;2;0;0;0;0
CE;2020-02-16;0;2;0;0;0;0
CE;2020-02-17;0;2;0;0;0;0
CE;2020-02-18;0;2;0;0;0;0
CE;2020-02-19;0;2;0;0;0;0
CE;2020-02-20;0;2;0;0;0;0
CE;2020-02-21;0;2;0;0;0;0
CE;2020-02-22;0;2;0;0;0;0
CE;2020-02-23;0;2;0;0;0;0
CE;2020-02-24;0;2;0;0;0;0
CE;2020-02-25;0;2;0;0;0;0
CE;2020-02-26;0;2;0;0;0;0
CE;2020-02-27;0;2;0;0;0;0
CE;2020-02-28;0;2;0;0;0;0
CE;2020-02-29;0;2;0;0;0;0
CE;2020-03-01;0;2;0;0;0;0
CE;2020-03-02;0;2;0;0;0;0
CE;2020-03-03;2;4;0;1;0;1
CE;2020-03-04;0;4;0;0;0;0
CE;2020-03-05;1;5;0;1;0;0
CE;2020-03-06;0;5;0;0;0;0
CE;2020-03-07;0;5;0;0;0;0
CE;2020-03-08;1;6;0;0;0;1
CE;2020-03-09;1;7;0;1;0;0
CE;2020-03-10;1;8;0;0;0;1
CE;2020-03-11;3;11;0;1;0;2
CE;2020-03-12;1;12;0;0;0;1
CE;2020-03-13;6;18;1;0;0;5
CE;2020-03-14;4;22;0;1;0;3
CE;2020-03-15;2;24;0;1;0;1
CE;2020-03-16;6;30;1;1;0;4
CE;2020-03-17;5;35;0;1;0;4
CE;2020-03-18;6;41;0;2;0;4
CE;2020-03-19;5;46;0;2;0;3
CE;2020-03-20;7;53;0;1;0;6
CE;2020-03-21;7;60;0;1;0;6
CE;2020-03-22;7;67;0;0;0;7
CE;2020-03-23;9;76;0;6;0;3
CE;2020-03-24;8;84;0;0;0;8
CE;2020-03-25;9;93;1;2;0;6
CE;2020-03-26;5;98;1;1;0;3
CE;2020-03-27;2;100;0;1;0;1
CE;2020-03-28;5;105;0;0;0;5
CE;2020-03-29;7;112;0;0;0;7
CE;2020-03-30;5;117;0;1;0;4
CE;2020-03-31;2;119;0;0;0;2
CE;2020-04-01;8;127;0;6;0;2
CE;2020-04-02;2;129;0;1;0;1
CE;2020-04-03;2;131;0;1;0;1
CE;2020-04-04;2;133;0;0;0;2
CE;2020-04-05;2;135;0;0;0;2
CE;2020-04-06;3;138;1;0;0;2
CE;2020-04-07;2;140;0;0;0;2
CE;2020-04-08;1;141;0;1;0;0
CE;2020-04-09;3;144;1;1;0;1
CE;2020-04-10;1;145;0;0;0;1
CE;2020-04-11;2;147;0;2;0;0
CE;2020-04-12;0;147;0;0;0;0
CE;2020-04-13;2;149;0;1;0;1
CE;2020-04-14;0;149;0;0;0;0
CE;2020-04-15;0;149;0;0;0;0
CE;2020-04-16;1;150;1;0;0;0
CE;2020-04-17;1;151;0;1;0;0
CE;2020-04-18;1;152;0;1;0;0
CE;2020-04-19;0;152;0;0;0;0
CE;2020-04-20;1;153;1;0;0;0
CE;2020-04-21;2;155;0;2;0;0
CE;2020-04-22;3;158;1;2;0;0
CE;2020-04-23;3;161;0;3;0;0
CE;2020-04-24;1;162;0;1;0;0
CE;2020-04-25;1;163;1;0;0;0
CE;2020-04-26;0;163;0;0;0;0
CE;2020-04-27;1;164;1;0;0;0
CE;2020-04-28;2;166;1;1;0;0
CE;2020-04-29;4;170;4;0;0;0
CE;2020-04-30;0;170;0;0;0;0
CE;2020-05-01;1;171;1;0;0;0
CE;2020-05-02;2;173;2;0;0;0
CE;2020-05-03;0;173;0;0;0;0
CE;2020-05-04;0;173;0;0;0;0
CE;2020-05-05;0;173;0;0;0;0
CE;2020-05-06;1;174;1;0;0;0
CE;2020-05-07;1;175;1;0;0;0
CE;2020-05-08;0;175;0;0;0;0
CE;2020-05-09;0;175;0;0;0;0
CE;2020-05-10;0;175;0;0;0;0
CE;2020-05-11;1;176;1;0;0;0
CE;2020-05-12;2;178;2;0;0;0
CE;2020-05-13;0;178;0;0;0;0
CE;2020-05-14;0;178;0;0;0;0
CE;2020-05-15;0;178;0;0;0;0
CE;2020-05-16;1;179;1;0;0;0
CE;2020-05-17;0;179;0;0;0;0
CE;2020-05-18;2;181;2;0;0;0
CE;2020-05-19;3;184;3;0;0;0
CE;2020-05-20;1;185;1;0;0;0
CE;2020-05-21;1;186;1;0;0;0
CE;2020-05-22;0;186;0;0;0;0
CE;2020-05-23;5;191;5;0;0;0
CE;2020-05-24;2;193;2;0;0;0
CE;2020-05-25;5;198;5;0;0;0
CE;2020-05-26;1;199;1;0;0;0
CE;2020-05-27;2;201;2;0;0;0
CE;2020-05-28;5;206;5;0;0;0
CE;2020-05-29;2;208;2;0;0;0
CE;2020-05-30;3;211;3;0;0;0
CE;2020-05-31;1;212;1;0;0;0
CE;2020-06-01;4;216;4;0;0;0
CE;2020-06-02;2;218;2;0;0;0
CE;2020-06-03;4;222;4;0;0;0
CE;2020-06-04;0;222;0;0;0;0
CE;2020-06-05;0;222;0;0;0;0
CE;2020-06-06;0;222;0;0;0;0
CE;2020-06-07;0;222;0;0;0;0
CE;2020-06-08;0;222;0;0;0;0
CE;2020-06-09;0;222;0;0;0;0
CE;2020-06-10;0;222;0;0;0;0
CE;2020-06-11;0;222;0;0;0;0
CE;2020-06-12;0;222;0;0;0;0
CE;2020-06-13;0;222;0;0;0;0
CE;2020-06-14;0;222;0;0;0;0
CE;2020-06-15;0;222;0;0;0;0
CE;2020-06-16;0;222;0;0;0;0
CE;2020-06-17;0;222;0;0;0;0
CE;2020-06-18;0;222;0;0;0;0
CE;2020-06-19;0;222;0;0;0;0
CE;2020-06-20;0;222;0;0;0;0
CE;2020-06-21;0;222;0;0;0;0
CE;2020-06-22;0;222;0;0;0;0
CE;2020-06-23;0;222;0;0;0;0
CE;2020-06-24;0;222;0;0;0;0
CE;2020-06-25;0;222;0;0;0;0
CE;2020-06-26;0;222;0;0;0;0
CE;2020-06-27;0;222;0;0;0;0
CE;2020-06-28;0;222;0;0;0;0
CE;2020-06-29;0;222;0;0;0;0
CE;2020-06-30;0;222;0;0;0;0
CE;2020-07-01;0;222;0;0;0;0
CE;2020-07-02;0;222;0;0;0;0
CE;2020-07-03;0;222;0;0;0;0
CE;2020-07-04;0;222;0;0;0;0
CE;2020-07-05;0;222;0;0;0;0
CE;2020-07-06;0;222;0;0;0;0
CE;2020-07-07;0;222;0;0;0;0
CE;2020-07-08;0;222;0;0;0;0
CE;2020-07-09;0;222;0;0;0;0
CE;2020-07-10;0;222;0;0;0;0
CE;2020-07-11;0;222;0;0;0;0
CE;2020-07-12;0;222;0;0;0;0
CE;2020-07-13;0;222;0;0;0;0
CE;2020-07-14;1;223;1;0;0;0
CE;2020-07-15;0;223;0;0;0;0
CE;2020-07-16;0;223;0;0;0;0
CE;2020-07-17;0;223;0;0;0;0
CE;2020-07-18;0;223;0;0;0;0
CE;2020-07-19;0;223;0;0;0;0
CE;2020-07-20;0;223;0;0;0;0
CE;2020-07-21;0;223;0;0;0;0
CE;2020-07-22;1;224;1;0;0;0
CE;2020-07-23;0;224;0;0;0;0
CE;2020-07-24;0;224;0;0;0;0
CE;2020-07-25;0;224;0;0;0;0
CE;2020-07-26;1;225;1;0;0;0
CE;2020-07-27;0;225;0;0;0;0
CE;2020-07-28;0;225;0;0;0;0
CE;2020-07-29;0;225;0;0;0;0
CE;2020-07-30;0;225;0;0;0;0
CE;2020-07-31;0;225;0;0;0;0
CE;2020-08-01;0;225;0;0;0;0
CE;2020-08-02;0;225;0;0;0;0
CE;2020-08-03;0;225;0;0;0;0
CE;2020-08-04;0;225;0;0;0;0
CE;2020-08-05;0;225;0;0;0;0
CE;2020-08-06;1;226;1;0;0;0
CE;2020-08-07;1;227;1;0;0;0
CE;2020-08-08;0;227;0;0;0;0
CE;2020-08-09;1;228;1;0;0;0
CE;2020-08-10;1;229;1;0;0;0
CE;2020-08-11;3;232;3;0;0;0
CE;2020-08-12;2;234;2;0;0;0
CE;2020-08-13;4;238;4;0;0;0
CE;2020-08-14;7;245;7;0;0;0
CE;2020-08-15;5;250;5;0;0;0
CE;2020-08-16;1;251;1;0;0;0
CL;2020-01-31;0;0;0;0;0;0
CL;2020-02-01;0;0;0;0;0;0
CL;2020-02-02;0;0;0;0;0;0
CL;2020-02-03;1;1;0;1;0;0
CL;2020-02-04;1;2;1;0;0;0
CL;2020-02-05;1;3;1;0;0;0
CL;2020-02-06;0;3;0;0;0;0
CL;2020-02-07;1;4;1;0;0;0
CL;2020-02-08;0;4;0;0;0;0
CL;2020-02-09;0;4;0;0;0;0
CL;2020-02-10;1;5;0;1;0;0
CL;2020-02-11;1;6;1;0;0;0
CL;2020-02-12;2;8;2;0;0;0
CL;2020-02-13;3;11;0;3;0;0
CL;2020-02-14;1;12;1;0;0;0
CL;2020-02-15;0;12;0;0;0;0
CL;2020-02-16;0;12;0;0;0;0
CL;2020-02-17;0;12;0;0;0;0
CL;2020-02-18;1;13;1;0;0;0
CL;2020-02-19;1;14;0;1;0;0
CL;2020-02-20;3;17;1;2;0;0
CL;2020-02-21;5;22;3;2;0;0
CL;2020-02-22;2;24;2;0;0;0
CL;2020-02-23;5;29;4;1;0;0
CL;2020-02-24;5;34;4;1;0;0
CL;2020-02-25;6;40;5;1;0;0
CL;2020-02-26;8;48;7;1;0;0
CL;2020-02-27;7;55;6;1;0;0
CL;2020-02-28;11;66;8;3;0;0
CL;2020-02-29;10;76;10;0;0;0
CL;2020-03-01;32;108;28;4;0;0
CL;2020-03-02;44;152;37;7;0;0
CL;2020-03-03;29;181;27;2;0;0
CL;2020-03-04;35;216;31;4;0;0
CL;2020-03-05;55;271;46;9;0;0
CL;2020-03-06;57;328;49;8;0;0
CL;2020-03-07;83;411;71;12;0;0
CL;2020-03-08;80;491;70;10;0;0
CL;2020-03-09;167;658;147;20;0;0
CL;2020-03-10;214;872;192;22;0;0
CL;2020-03-11;257;1129;220;36;0;1
CL;2020-03-12;344;1473;308;36;0;0
CL;2020-03-13;505;1978;446;59;0;0
CL;2020-03-14;522;2500;466;55;1;0
CL;2020-03-15;537;3037;471;65;0;1
CL;2020-03-16;780;3817;679;100;1;0
CL;2020-03-17;730;4547;655;74;1;0
CL;2020-03-18;815;5362;732;83;0;0
CL;2020-03-19;866;6228;799;67;0;0
CL;2020-03-20;955;7183;830;125;0;0
CL;2020-03-21;765;7948;696;69;0;0
CL;2020-03-22;708;8656;632;76;0;0
CL;2020-03-23;769;9425;664;105;0;0
CL;2020-03-24;664;10089;556;106;1;1
CL;2020-03-25;695;10784;598;97;0;0
CL;2020-03-26;555;11339;477;78;0;0
CL;2020-03-27;524;11863;456;68;0;0
CL;2020-03-28;523;12386;461;62;0;0
CL;2020-03-29;424;12810;388;36;0;0
CL;2020-03-30;497;13307;422;74;0;1
CL;2020-03-31;399;13706;359;40;0;0
CL;2020-04-01;561;14267;449;112;0;0
CL;2020-04-02;518;14785;446;72;0;0
CL;2020-04-03;568;15353;492;76;0;0
CL;2020-04-04;569;15922;482;87;0;0
CL;2020-04-05;390;16312;318;72;0;0
CL;2020-04-06;594;16906;461;133;0;0
CL;2020-04-07;429;17335;327;102;0;0
CL;2020-04-08;509;17844;372;136;1;0
CL;2020-04-09;537;18381;351;186;0;0
CL;2020-04-10;558;18939;324;234;0;0
CL;2020-04-11;481;19420;310;171;0;0
CL;2020-04-12;326;19746;159;167;0;0
CL;2020-04-13;511;20257;234;277;0;0
CL;2020-04-14;461;20718;201;260;0;0
CL;2020-04-15;342;21060;174;168;0;0
CL;2020-04-16;298;21358;143;155;0;0
CL;2020-04-17;205;21563;145;60;0;0
CL;2020-04-18;171;21734;94;76;1;0
CL;2020-04-19;217;21951;136;81;0;0
CL;2020-04-20;260;22211;195;64;1;0
CL;2020-04-21;278;22489;119;159;0;0
CL;2020-04-22;255;22744;163;92;0;0
CL;2020-04-23;212;22956;79;132;0;1
CL;2020-04-24;292;23248;138;154;0;0
CL;2020-04-25;139;23387;87;52;0;0
CL;2020-04-26;108;23495;41;67;0;0
CL;2020-04-27;132;23627;44;88;0;0
CL;2020-04-28;323;23950;64;259;0;0
CL;2020-04-29;244;24194;47;197;0;0
CL;2020-04-30;235;24429;67;168;0;0
CL;2020-05-01;336;24765;53;281;2;0
CL;2020-05-02;344;25109;58;286;0;0
CL;2020-05-03;113;25222;58;55;0;0
CL;2020-05-04;92;25314;28;64;0;0
CL;2020-05-05;43;25357;13;30;0;0
CL;2020-05-06;27;25384;12;15;0;0
CL;2020-05-07;30;25414;21;9;0;0
CL;2020-05-08;30;25444;17;13;0;0
CL;2020-05-09;14;25458;9;4;1;0
CL;2020-05-10;12;25470;10;2;0;0
CL;2020-05-11;27;25497;26;1;0;0
CL;2020-05-12;34;25531;30;2;2;0
CL;2020-05-13;57;25588;55;1;1;0
CL;2020-05-14;39;25627;38;0;1;0
CL;2020-05-15;35;25662;33;0;2;0
CL;2020-05-16;30;25692;28;1;1;0
CL;2020-05-17;6;25698;6;0;0;0
CL;2020-05-18;32;25730;32;0;0;0
CL;2020-05-19;35;25765;34;1;0;0
CL;2020-05-20;27;25792;26;0;1;0
CL;2020-05-21;39;25831;38;0;1;0
CL;2020-05-22;41;25872;40;1;0;0
CL;2020-05-23;16;25888;16;0;0;0
CL;2020-05-24;12;25900;12;0;0;0
CL;2020-05-25;34;25934;33;0;1;0
CL;2020-05-26;45;25979;45;0;0;0
CL;2020-05-27;25;26004;25;0;0;0
CL;2020-05-28;44;26048;44;0;0;0
CL;2020-05-29;42;26090;41;0;1;0
CL;2020-05-30;37;26127;37;0;0;0
CL;2020-05-31;19;26146;19;0;0;0
CL;2020-06-01;28;26174;28;0;0;0
CL;2020-06-02;19;26193;19;0;0;0
CL;2020-06-03;27;26220;27;0;0;0
CL;2020-06-04;28;26248;26;0;2;0
CL;2020-06-05;36;26284;36;0;0;0
CL;2020-06-06;11;26295;11;0;0;0
CL;2020-06-07;13;26308;13;0;0;0
CL;2020-06-08;35;26343;35;0;0;0
CL;2020-06-09;26;26369;25;0;1;0
CL;2020-06-10;17;26386;16;0;1;0
CL;2020-06-11;17;26403;17;0;0;0
CL;2020-06-12;21;26424;20;0;1;0
CL;2020-06-13;12;26436;11;0;1;0
CL;2020-06-14;7;26443;5;0;2;0
CL;2020-06-15;15;26458;15;0;0;0
CL;2020-06-16;42;26500;41;0;1;0
CL;2020-06-17;18;26518;18;0;0;0
CL;2020-06-18;11;26529;10;0;1;0
CL;2020-06-19;14;26543;13;0;1;0
CL;2020-06-20;16;26559;15;0;1;0
CL;2020-06-21;6;26565;6;0;0;0
CL;2020-06-22;14;26579;14;0;0;0
CL;2020-06-23;29;26608;28;0;1;0
CL;2020-06-24;14;26622;14;0;0;0
CL;2020-06-25;16;26638;16;0;0;0
CL;2020-06-26;15;26653;15;0;0;0
CL;2020-06-27;13;26666;13;0;0;0
CL;2020-06-28;5;26671;5;0;0;0
CL;2020-06-29;11;26682;11;0;0;0
CL;2020-06-30;13;26695;13;0;0;0
CL;2020-07-01;10;26705;9;0;1;0
CL;2020-07-02;9;26714;9;0;0;0
CL;2020-07-03;11;26725;11;0;0;0
CL;2020-07-04;7;26732;7;0;0;0
CL;2020-07-05;3;26735;3;0;0;0
CL;2020-07-06;12;26747;11;0;1;0
CL;2020-07-07;10;26757;9;0;1;0
CL;2020-07-08;13;26770;12;0;1;0
CL;2020-07-09;8;26778;8;0;0;0
CL;2020-07-10;15;26793;14;0;1;0
CL;2020-07-11;13;26806;13;0;0;0
CL;2020-07-12;7;26813;7;0;0;0
CL;2020-07-13;21;26834;21;0;0;0
CL;2020-07-14;21;26855;20;0;1;0
CL;2020-07-15;14;26869;14;0;0;0
CL;2020-07-16;21;26890;21;0;0;0
CL;2020-07-17;16;26906;15;0;1;0
CL;2020-07-18;27;26933;25;0;2;0
CL;2020-07-19;24;26957;23;0;1;0
CL;2020-07-20;35;26992;34;0;1;0
CL;2020-07-21;20;27012;20;0;0;0
CL;2020-07-22;24;27036;24;0;0;0
CL;2020-07-23;44;27080;44;0;0;0
CL;2020-07-24;37;27117;37;0;0;0
CL;2020-07-25;26;27143;26;0;0;0
CL;2020-07-26;27;27170;27;0;0;0
CL;2020-07-27;69;27239;67;0;2;0
CL;2020-07-28;84;27323;84;0;0;0
CL;2020-07-29;77;27400;77;0;0;0
CL;2020-07-30;71;27471;70;0;1;0
CL;2020-07-31;147;27618;146;0;1;0
CL;2020-08-01;80;27698;80;0;0;0
CL;2020-08-02;79;27777;79;0;0;0
CL;2020-08-03;100;27877;100;0;0;0
CL;2020-08-04;207;28084;207;0;0;0
CL;2020-08-05;207;28291;207;0;0;0
CL;2020-08-06;164;28455;164;0;0;0
CL;2020-08-07;250;28705;249;0;1;0
CL;2020-08-08;164;28869;164;0;0;0
CL;2020-08-09;284;29153;284;0;0;0
CL;2020-08-10;190;29343;190;0;0;0
CL;2020-08-11;234;29577;233;0;0;1
CL;2020-08-12;288;29865;288;0;0;0
CL;2020-08-13;266;30131;266;0;0;0
CL;2020-08-14;312;30443;312;0;0;0
CL;2020-08-15;237;30680;237;0;0;0
CL;2020-08-16;190;30870;190;0;0;0
CM;2020-01-31;0;0;0;0;0;0
CM;2020-02-01;0;0;0;0;0;0
CM;2020-02-02;0;0;0;0;0;0
CM;2020-02-03;0;0;0;0;0;0
CM;2020-02-04;0;0;0;0;0;0
CM;2020-02-05;0;0;0;0;0;0
CM;2020-02-06;0;0;0;0;0;0
CM;2020-02-07;0;0;0;0;0;0
CM;2020-02-08;0;0;0;0;0;0
CM;2020-02-09;0;0;0;0;0;0
CM;2020-02-10;0;0;0;0;0;0
CM;2020-02-11;0;0;0;0;0;0
CM;2020-02-12;0;0;0;0;0;0
CM;2020-02-13;0;0;0;0;0;0
CM;2020-02-14;0;0;0;0;0;0
CM;2020-02-15;0;0;0;0;0;0
CM;2020-02-16;0;0;0;0;0;0
CM;2020-02-17;0;0;0;0;0;0
CM;2020-02-18;0;0;0;0;0;0
CM;2020-02-19;0;0;0;0;0;0
CM;2020-02-20;2;2;1;0;0;1
CM;2020-02-21;0;2;0;0;0;0
CM;2020-02-22;0;2;0;0;0;0
CM;2020-02-23;0;2;0;0;0;0
CM;2020-02-24;4;6;0;0;0;4
CM;2020-02-25;4;10;1;0;0;3
CM;2020-02-26;5;15;2;0;0;3
CM;2020-02-27;9;24;2;0;0;7
CM;2020-02-28;11;35;4;1;0;6
CM;2020-02-29;15;50;3;0;0;12
CM;2020-03-01;66;116;15;0;3;48
CM;2020-03-02;62;178;18;0;5;39
CM;2020-03-03;48;226;15;0;0;33
CM;2020-03-04;60;286;17;1;2;40
CM;2020-03-05;77;363;20;1;2;54
CM;2020-03-06;100;463;27;0;0;73
CM;2020-03-07;141;604;32;0;1;108
CM;2020-03-08;161;765;27;0;0;134
CM;2020-03-09;208;973;45;0;0;163
CM;2020-03-10;291;1264;81;1;0;209
CM;2020-03-11;324;1588;76;2;1;245
CM;2020-03-12;454;2042;111;4;3;336
CM;2020-03-13;628;2670;183;1;3;441
CM;2020-03-14;606;3276;159;1;2;444
CM;2020-03-15;774;4050;250;3;6;515
CM;2020-03-16;809;4859;239;3;1;566
CM;2020-03-17;745;5604;199;5;2;539
CM;2020-03-18;791;6395;216;4;1;570
CM;2020-03-19;745;7140;242;3;2;498
CM;2020-03-20;935;8075;309;8;6;612
CM;2020-03-21;623;8698;199;5;1;418
CM;2020-03-22;663;9361;178;12;0;473
CM;2020-03-23;756;10117;248;13;1;494
CM;2020-03-24;647;10764;249;17;1;380
CM;2020-03-25;665;11429;241;20;3;401
CM;2020-03-26;587;12016;240;16;2;329
CM;2020-03-27;509;12525;200;14;3;292
CM;2020-03-28;410;12935;166;25;1;218
CM;2020-03-29;372;13307;171;20;0;181
CM;2020-03-30;523;13830;230;22;3;268
CM;2020-03-31;411;14241;168;30;2;211
CM;2020-04-01;461;14702;193;35;1;232
CM;2020-04-02;366;15068;147;24;1;194
CM;2020-04-03;341;15409;148;27;1;165
CM;2020-04-04;381;15790;144;35;0;202
CM;2020-04-05;462;16252;237;33;1;191
CM;2020-04-06;416;16668;126;25;1;264
CM;2020-04-07;363;17031;97;23;0;243
CM;2020-04-08;365;17396;106;21;0;238
CM;2020-04-09;344;17740;81;9;2;252
CM;2020-04-10;298;18038;70;18;0;210
CM;2020-04-11;155;18193;59;13;0;83
CM;2020-04-12;225;18418;72;6;0;147
CM;2020-04-13;327;18745;106;10;1;210
CM;2020-04-14;233;18978;67;17;0;149
CM;2020-04-15;180;19158;77;6;0;97
CM;2020-04-16;127;19285;33;10;0;84
CM;2020-04-17;145;19430;24;14;0;107
CM;2020-04-18;97;19527;32;6;0;59
CM;2020-04-19;106;19633;34;1;0;71
CM;2020-04-20;142;19775;53;3;0;86
CM;2020-04-21;147;19922;34;4;0;109
CM;2020-04-22;150;20072;24;5;0;121
CM;2020-04-23;88;20160;22;2;0;64
CM;2020-04-24;56;20216;15;0;1;40
CM;2020-04-25;52;20268;14;2;0;36
CM;2020-04-26;95;20363;17;4;0;74
CM;2020-04-27;104;20467;24;1;0;79
CM;2020-04-28;92;20559;17;1;0;74
CM;2020-04-29;69;20628;8;2;2;57
CM;2020-04-30;74;20702;8;0;0;66
CM;2020-05-01;21;20723;9;3;0;9
CM;2020-05-02;16;20739;6;4;0;6
CM;2020-05-03;47;20786;5;2;0;40
CM;2020-05-04;21;20807;17;1;1;2
CM;2020-05-05;11;20818;11;0;0;0
CM;2020-05-06;10;20828;10;0;0;0
CM;2020-05-07;14;20842;13;0;1;0
CM;2020-05-08;7;20849;7;0;0;0
CM;2020-05-09;10;20859;10;0;0;0
CM;2020-05-10;12;20871;11;1;0;0
CM;2020-05-11;29;20900;25;0;4;0
CM;2020-05-12;31;20931;28;0;3;0
CM;2020-05-13;38;20969;36;0;2;0
CM;2020-05-14;29;20998;27;0;2;0
CM;2020-05-15;36;21034;34;0;2;0
CM;2020-05-16;27;21061;25;0;2;0
CM;2020-05-17;12;21073;9;0;3;0
CM;2020-05-18;29;21102;25;0;4;0
CM;2020-05-19;33;21135;28;0;5;0
CM;2020-05-20;26;21161;26;0;0;0
CM;2020-05-21;19;21180;17;0;2;0
CM;2020-05-22;43;21223;39;0;4;0
CM;2020-05-23;31;21254;26;0;5;0
CM;2020-05-24;18;21272;15;0;3;0
CM;2020-05-25;34;21306;33;0;1;0
CM;2020-05-26;38;21344;34;0;4;0
CM;2020-05-27;40;21384;39;0;1;0
CM;2020-05-28;35;21419;33;0;2;0
CM;2020-05-29;30;21449;30;0;0;0
CM;2020-05-30;25;21474;23;0;2;0
CM;2020-05-31;12;21486;10;0;2;0
CM;2020-06-01;23;21509;22;0;1;0
CM;2020-06-02;29;21538;18;0;11;0
CM;2020-06-03;38;21576;37;0;1;0
CM;2020-06-04;37;21613;31;0;6;0
CM;2020-06-05;35;21648;34;0;1;0
CM;2020-06-06;14;21662;14;0;0;0
CM;2020-06-07;12;21674;12;0;0;0
CM;2020-06-08;27;21701;27;0;0;0
CM;2020-06-09;22;21723;22;0;0;0
CM;2020-06-10;20;21743;19;0;1;0
CM;2020-06-11;7;21750;7;0;0;0
CM;2020-06-12;19;21769;18;0;1;0
CM;2020-06-13;10;21779;10;0;0;0
CM;2020-06-14;10;21789;10;0;0;0
CM;2020-06-15;11;21800;11;0;0;0
CM;2020-06-16;21;21821;21;0;0;0
CM;2020-06-17;14;21835;14;0;0;0
CM;2020-06-18;9;21844;9;0;0;0
CM;2020-06-19;10;21854;10;0;0;0
CM;2020-06-20;15;21869;15;0;0;0
CM;2020-06-21;7;21876;7;0;0;0
CM;2020-06-22;12;21888;12;0;0;0
CM;2020-06-23;24;21912;24;0;0;0
CM;2020-06-24;17;21929;17;0;0;0
CM;2020-06-25;20;21949;20;0;0;0
CM;2020-06-26;11;21960;11;0;0;0
CM;2020-06-27;14;21974;14;0;0;0
CM;2020-06-28;11;21985;10;0;1;0
CM;2020-06-29;12;21997;12;0;0;0
CM;2020-06-30;14;22011;14;0;0;0
CM;2020-07-01;19;22030;19;0;0;0
CM;2020-07-02;14;22044;14;0;0;0
CM;2020-07-03;20;22064;20;0;0;0
CM;2020-07-04;10;22074;10;0;0;0
CM;2020-07-05;3;22077;3;0;0;0
CM;2020-07-06;17;22094;17;0;0;0
CM;2020-07-07;15;22109;15;0;0;0
CM;2020-07-08;18;22127;18;0;0;0
CM;2020-07-09;26;22153;26;0;0;0
CM;2020-07-10;23;22176;23;0;0;0
CM;2020-07-11;11;22187;11;0;0;0
CM;2020-07-12;10;22197;10;0;0;0
CM;2020-07-13;16;22213;16;0;0;0
CM;2020-07-14;23;22236;23;0;0;0
CM;2020-07-15;27;22263;27;0;0;0
CM;2020-07-16;24;22287;24;0;0;0
CM;2020-07-17;25;22312;25;0;0;0
CM;2020-07-18;12;22324;12;0;0;0
CM;2020-07-19;11;22335;11;0;0;0
CM;2020-07-20;23;22358;23;0;0;0
CM;2020-07-21;24;22382;24;0;0;0
CM;2020-07-22;38;22420;38;0;0;0
CM;2020-07-23;20;22440;20;0;0;0
CM;2020-07-24;42;22482;42;0;0;0
CM;2020-07-25;24;22506;24;0;0;0
CM;2020-07-26;21;22527;21;0;0;0
CM;2020-07-27;39;22566;39;0;0;0
CM;2020-07-28;43;22609;43;0;0;0
CM;2020-07-29;52;22661;52;0;0;0
CM;2020-07-30;41;22702;41;0;0;0
CM;2020-07-31;67;22769;67;0;0;0
CM;2020-08-01;55;22824;55;0;0;0
CM;2020-08-02;59;22883;59;0;0;0
CM;2020-08-03;75;22958;75;0;0;0
CM;2020-08-04;97;23055;97;0;0;0
CM;2020-08-05;93;23148;93;0;0;0
CM;2020-08-06;115;23263;115;0;0;0
CM;2020-08-07;109;23372;109;0;0;0
CM;2020-08-08;128;23500;128;0;0;0
CM;2020-08-09;103;23603;103;0;0;0
CM;2020-08-10;152;23755;152;0;0;0
CM;2020-08-11;164;23919;164;0;0;0
CM;2020-08-12;163;24082;163;0;0;0
CM;2020-08-13;176;24258;176;0;0;0
CM;2020-08-14;125;24383;125;0;0;0
CM;2020-08-15;103;24486;103;0;0;0
CM;2020-08-16;45;24531;45;0;0;0
CN;2020-01-31;0;0;0;0;0;0
CN;2020-02-01;0;0;0;0;0;0
CN;2020-02-02;1;1;0;0;0;1
CN;2020-02-03;0;1;0;0;0;0
CN;2020-02-04;1;2;1;0;0;0
CN;2020-02-05;0;2;0;0;0;0
CN;2020-02-06;0;2;0;0;0;0
CN;2020-02-07;0;2;0;0;0;0
CN;2020-02-08;0;2;0;0;0;0
CN;2020-02-09;0;2;0;0;0;0
CN;2020-02-10;0;2;0;0;0;0
CN;2020-02-11;0;2;0;0;0;0
CN;2020-02-12;1;3;1;0;0;0
CN;2020-02-13;0;3;0;0;0;0
CN;2020-02-14;1;4;1;0;0;0
CN;2020-02-15;0;4;0;0;0;0
CN;2020-02-16;2;6;2;0;0;0
CN;2020-02-17;0;6;0;0;0;0
CN;2020-02-18;1;7;1;0;0;0
CN;2020-02-19;1;8;1;0;0;0
CN;2020-02-20;1;9;1;0;0;0
CN;2020-02-21;0;9;0;0;0;0
CN;2020-02-22;0;9;0;0;0;0
CN;2020-02-23;2;11;2;0;0;0
CN;2020-02-24;0;11;0;0;0;0
CN;2020-02-25;2;13;1;0;0;1
CN;2020-02-26;7;20;7;0;0;0
CN;2020-02-27;1;21;1;0;0;0
CN;2020-02-28;8;29;7;0;0;1
CN;2020-02-29;6;35;6;0;0;0
CN;2020-03-01;7;42;7;0;0;0
CN;2020-03-02;12;54;12;0;0;0
CN;2020-03-03;8;62;8;0;0;0
CN;2020-03-04;14;76;14;0;0;0
CN;2020-03-05;16;92;15;0;0;1
CN;2020-03-06;25;117;24;0;0;1
CN;2020-03-07;19;136;18;0;0;1
CN;2020-03-08;35;171;31;0;0;4
CN;2020-03-09;47;218;40;0;0;7
CN;2020-03-10;55;273;50;0;0;5
CN;2020-03-11;59;332;54;0;0;5
CN;2020-03-12;73;405;69;0;0;4
CN;2020-03-13;109;514;100;0;0;9
CN;2020-03-14;97;611;93;0;0;4
CN;2020-03-15;91;702;89;0;0;2
CN;2020-03-16;132;834;116;0;0;16
CN;2020-03-17;93;927;90;0;0;3
CN;2020-03-18;117;1044;109;0;0;8
CN;2020-03-19;78;1122;70;0;0;8
CN;2020-03-20;117;1239;111;0;0;6
CN;2020-03-21;86;1325;77;0;0;9
CN;2020-03-22;75;1400;73;0;0;2
CN;2020-03-23;97;1497;91;0;0;6
CN;2020-03-24;63;1560;59;0;0;4
CN;2020-03-25;55;1615;54;0;0;1
CN;2020-03-26;62;1677;60;0;0;2
CN;2020-03-27;71;1748;69;0;0;2
CN;2020-03-28;36;1784;35;0;0;1
CN;2020-03-29;42;1826;42;0;0;0
CN;2020-03-30;51;1877;49;0;0;2
CN;2020-03-31;28;1905;27;0;0;1
CN;2020-04-01;52;1957;51;0;0;1
CN;2020-04-02;34;1991;32;0;0;2
CN;2020-04-03;17;2008;17;0;0;0
CN;2020-04-04;29;2037;28;0;0;1
CN;2020-04-05;17;2054;15;0;0;2
CN;2020-04-06;13;2067;13;0;0;0
CN;2020-04-07;26;2093;24;0;0;2
CN;2020-04-08;16;2109;14;0;0;2
CN;2020-04-09;27;2136;24;0;0;3
CN;2020-04-10;14;2150;13;0;0;1
CN;2020-04-11;14;2164;14;0;0;0
CN;2020-04-12;8;2172;8;0;0;0
CN;2020-04-13;13;2185;12;0;0;1
CN;2020-04-14;13;2198;12;0;0;1
CN;2020-04-15;15;2213;15;0;0;0
CN;2020-04-16;15;2228;14;0;0;1
CN;2020-04-17;8;2236;8;0;0;0
CN;2020-04-18;9;2245;9;0;0;0
CN;2020-04-19;15;2260;15;0;0;0
CN;2020-04-20;16;2276;15;0;0;1
CN;2020-04-21;7;2283;7;0;0;0
CN;2020-04-22;7;2290;7;0;0;0
CN;2020-04-23;5;2295;3;0;0;2
CN;2020-04-24;11;2306;10;0;0;1
CN;2020-04-25;4;2310;4;0;0;0
CN;2020-04-26;2;2312;2;0;0;0
CN;2020-04-27;3;2315;3;0;0;0
CN;2020-04-28;4;2319;1;0;0;3
CN;2020-04-29;4;2323;3;0;0;1
CN;2020-04-30;4;2327;4;0;0;0
CN;2020-05-01;9;2336;9;0;0;0
CN;2020-05-02;5;2341;5;0;0;0
CN;2020-05-03;0;2341;0;0;0;0
CN;2020-05-04;3;2344;3;0;0;0
CN;2020-05-05;2;2346;2;0;0;0
CN;2020-05-06;0;2346;0;0;0;0
CN;2020-05-07;1;2347;1;0;0;0
CN;2020-05-08;1;2348;1;0;0;0
CN;2020-05-09;2;2350;2;0;0;0
CN;2020-05-10;1;2351;1;0;0;0
CN;2020-05-11;2;2353;2;0;0;0
CN;2020-05-12;4;2357;4;0;0;0
CN;2020-05-13;5;2362;5;0;0;0
CN;2020-05-14;2;2364;2;0;0;0
CN;2020-05-15;3;2367;3;0;0;0
CN;2020-05-16;5;2372;5;0;0;0
CN;2020-05-17;1;2373;1;0;0;0
CN;2020-05-18;3;2376;3;0;0;0
CN;2020-05-19;8;2384;8;0;0;0
CN;2020-05-20;4;2388;4;0;0;0
CN;2020-05-21;5;2393;5;0;0;0
CN;2020-05-22;3;2396;3;0;0;0
CN;2020-05-23;1;2397;1;0;0;0
CN;2020-05-24;2;2399;2;0;0;0
CN;2020-05-25;4;2403;4;0;0;0
CN;2020-05-26;3;2406;3;0;0;0
CN;2020-05-27;2;2408;2;0;0;0
CN;2020-05-28;7;2415;7;0;0;0
CN;2020-05-29;8;2423;8;0;0;0
CN;2020-05-30;2;2425;2;0;0;0
CN;2020-05-31;1;2426;1;0;0;0
CN;2020-06-01;4;2430;4;0;0;0
CN;2020-06-02;5;2435;5;0;0;0
CN;2020-06-03;4;2439;4;0;0;0
CN;2020-06-04;1;2440;1;0;0;0
CN;2020-06-05;2;2442;2;0;0;0
CN;2020-06-06;4;2446;4;0;0;0
CN;2020-06-07;1;2447;1;0;0;0
CN;2020-06-08;2;2449;2;0;0;0
CN;2020-06-09;2;2451;2;0;0;0
CN;2020-06-10;2;2453;2;0;0;0
CN;2020-06-11;2;2455;1;0;0;1
CN;2020-06-12;3;2458;3;0;0;0
CN;2020-06-13;2;2460;2;0;0;0
CN;2020-06-14;1;2461;1;0;0;0
CN;2020-06-15;1;2462;1;0;0;0
CN;2020-06-16;2;2464;2;0;0;0
CN;2020-06-17;14;2478;14;0;0;0
CN;2020-06-18;0;2478;0;0;0;0
CN;2020-06-19;1;2479;1;0;0;0
CN;2020-06-20;11;2490;11;0;0;0
CN;2020-06-21;2;2492;2;0;0;0
CN;2020-06-22;1;2493;1;0;0;0
CN;2020-06-23;6;2499;6;0;0;0
CN;2020-06-24;1;2500;1;0;0;0
CN;2020-06-25;1;2501;1;0;0;0
CN;2020-06-26;1;2502;1;0;0;0
CN;2020-06-27;0;2502;0;0;0;0
CN;2020-06-28;0;2502;0;0;0;0
CN;2020-06-29;0;2502;0;0;0;0
CN;2020-06-30;5;2507;5;0;0;0
CN;2020-07-01;6;2513;6;0;0;0
CN;2020-07-02;1;2514;1;0;0;0
CN;2020-07-03;4;2518;4;0;0;0
CN;2020-07-04;4;2522;4;0;0;0
CN;2020-07-05;2;2524;2;0;0;0
CN;2020-07-06;1;2525;0;0;0;1
CN;2020-07-07;4;2529;4;0;0;0
CN;2020-07-08;8;2537;8;0;0;0
CN;2020-07-09;7;2544;7;0;0;0
CN;2020-07-10;2;2546;2;0;0;0
CN;2020-07-11;1;2547;1;0;0;0
CN;2020-07-12;3;2550;3;0;0;0
CN;2020-07-13;6;2556;6;0;0;0
CN;2020-07-14;3;2559;3;0;0;0
CN;2020-07-15;9;2568;9;0;0;0
CN;2020-07-16;4;2572;4;0;0;0
CN;2020-07-17;7;2579;7;0;0;0
CN;2020-07-18;12;2591;12;0;0;0
CN;2020-07-19;53;2644;53;0;0;0
CN;2020-07-20;2;2646;2;0;0;0
CN;2020-07-21;11;2657;11;0;0;0
CN;2020-07-22;7;2664;7;0;0;0
CN;2020-07-23;11;2675;11;0;0;0
CN;2020-07-24;5;2680;5;0;0;0
CN;2020-07-25;10;2690;10;0;0;0
CN;2020-07-26;7;2697;7;0;0;0
CN;2020-07-27;8;2705;8;0;0;0
CN;2020-07-28;8;2713;8;0;0;0
CN;2020-07-29;5;2718;5;0;0;0
CN;2020-07-30;10;2728;10;0;0;0
CN;2020-07-31;15;2743;15;0;0;0
CN;2020-08-01;30;2773;30;0;0;0
CN;2020-08-02;28;2801;28;0;0;0
CN;2020-08-03;32;2833;32;0;0;0
CN;2020-08-04;54;2887;54;0;0;0
CN;2020-08-05;65;2952;65;0;0;0
CN;2020-08-06;74;3026;74;0;0;0
CN;2020-08-07;61;3087;61;0;0;0
CN;2020-08-08;64;3151;64;0;0;0
CN;2020-08-09;79;3230;79;0;0;0
CN;2020-08-10;122;3352;122;0;0;0
CN;2020-08-11;123;3475;123;0;0;0
CN;2020-08-12;141;3616;141;0;0;0
CN;2020-08-13;94;3710;93;0;0;1
CN;2020-08-14;103;3813;102;0;0;1
CN;2020-08-15;112;3925;108;0;0;4
CN;2020-08-16;75;4000;74;0;0;1
CT;2020-01-31;1;1;1;0;0;0
CT;2020-02-01;8;9;6;0;0;2
CT;2020-02-02;2;11;1;0;0;1
CT;2020-02-03;3;14;2;0;0;1
CT;2020-02-04;4;18;4;0;0;0
CT;2020-02-05;2;20;2;0;0;0
CT;2020-02-06;1;21;1;0;0;0
CT;2020-02-07;3;24;2;0;0;1
CT;2020-02-08;0;24;0;0;0;0
CT;2020-02-09;1;25;0;0;0;1
CT;2020-02-10;3;28;3;0;0;0
CT;2020-02-11;3;31;2;0;0;1
CT;2020-02-12;7;38;6;0;0;1
CT;2020-02-13;9;47;7;0;0;2
CT;2020-02-14;1;48;1;0;0;0
CT;2020-02-15;10;58;10;0;0;0
CT;2020-02-16;5;63;4;0;0;1
CT;2020-02-17;2;65;1;0;0;1
CT;2020-02-18;4;69;4;0;0;0
CT;2020-02-19;1;70;1;0;0;0
CT;2020-02-20;12;82;9;0;0;3
CT;2020-02-21;14;96;12;0;0;2
CT;2020-02-22;11;107;9;0;0;2
CT;2020-02-23;8;115;6;0;0;2
CT;2020-02-24;14;129;9;0;0;5
CT;2020-02-25;21;150;17;0;1;3
CT;2020-02-26;31;181;20;0;0;11
CT;2020-02-27;15;196;12;0;0;3
CT;2020-02-28;35;231;28;0;1;6
CT;2020-02-29;27;258;19;0;0;8
CT;2020-03-01;87;345;76;0;1;10
CT;2020-03-02;82;427;61;0;1;20
CT;2020-03-03;91;518;76;0;1;14
CT;2020-03-04;149;667;127;0;2;20
CT;2020-03-05;174;841;155;0;1;18
CT;2020-03-06;269;1110;238;0;3;28
CT;2020-03-07;295;1405;262;0;3;30
CT;2020-03-08;331;1736;303;0;1;27
CT;2020-03-09;569;2305;515;0;3;51
CT;2020-03-10;799;3104;724;0;1;74
CT;2020-03-11;760;3864;703;0;2;55
CT;2020-03-12;1030;4894;969;0;1;60
CT;2020-03-13;1365;6259;1268;0;6;91
CT;2020-03-14;1322;7581;1234;0;7;81
CT;2020-03-15;1371;8952;1290;0;12;69
CT;2020-03-16;1707;10659;1540;0;10;157
CT;2020-03-17;1567;12226;1476;0;9;82
CT;2020-03-18;1682;13908;1580;0;7;95
CT;2020-03-19;1608;15516;1522;0;5;81
CT;2020-03-20;1896;17412;1790;0;7;99
CT;2020-03-21;1457;18869;1386;0;8;63
CT;2020-03-22;1309;20178;1235;0;0;74
CT;2020-03-23;1508;21686;1405;0;11;92
CT;2020-03-24;1411;23097;1333;0;1;77
CT;2020-03-25;1323;24420;1250;0;3;70
CT;2020-03-26;1388;25808;1321;0;1;66
CT;2020-03-27;1255;27063;1196;0;5;54
CT;2020-03-28;1328;28391;1262;0;5;61
CT;2020-03-29;1042;29433;971;0;6;65
CT;2020-03-30;1202;30635;1105;0;8;89
CT;2020-03-31;1131;31766;1071;0;1;59
CT;2020-04-01;1285;33051;1217;0;7;61
CT;2020-04-02;1061;34112;1005;0;1;55
CT;2020-04-03;1209;35321;1166;1;3;39
CT;2020-04-04;969;36290;928;0;2;39
CT;2020-04-05;845;37135;805;0;0;40
CT;2020-04-06;816;37951;737;0;1;78
CT;2020-04-07;743;38694;677;0;0;66
CT;2020-04-08;995;39689;953;0;2;40
CT;2020-04-09;1052;40741;1009;0;1;42
CT;2020-04-10;1012;41753;966;0;1;45
CT;2020-04-11;1059;42812;1029;0;1;29
CT;2020-04-12;667;43479;646;0;0;21
CT;2020-04-13;597;44076;549;0;2;46
CT;2020-04-14;726;44802;697;0;1;28
CT;2020-04-15;750;45552;726;0;1;23
CT;2020-04-16;713;46265;699;0;0;14
CT;2020-04-17;610;46875;583;0;0;27
CT;2020-04-18;451;47326;427;0;0;24
CT;2020-04-19;266;47592;257;0;0;9
CT;2020-04-20;365;47957;337;0;1;27
CT;2020-04-21;199;48156;179;0;1;19
CT;2020-04-22;323;48479;302;0;1;20
CT;2020-04-23;274;48753;260;0;0;14
CT;2020-04-24;271;49024;245;0;1;25
CT;2020-04-25;173;49197;162;0;1;10
CT;2020-04-26;138;49335;132;0;0;6
CT;2020-04-27;144;49479;124;0;0;20
CT;2020-04-28;160;49639;153;0;0;7
CT;2020-04-29;152;49791;140;0;0;12
CT;2020-04-30;189;49980;176;0;1;12
CT;2020-05-01;164;50144;154;0;1;9
CT;2020-05-02;153;50297;148;0;0;5
CT;2020-05-03;139;50436;130;0;0;9
CT;2020-05-04;120;50556;113;0;1;6
CT;2020-05-05;65;50621;53;0;5;7
CT;2020-05-06;52;50673;42;0;1;9
CT;2020-05-07;63;50736;60;0;0;3
CT;2020-05-08;69;50805;63;0;2;4
CT;2020-05-09;57;50862;51;0;1;5
CT;2020-05-10;83;50945;80;0;0;3
CT;2020-05-11;116;51061;89;0;27;0
CT;2020-05-12;133;51194;105;0;27;1
CT;2020-05-13;154;51348;122;0;32;0
CT;2020-05-14;149;51497;103;0;46;0
CT;2020-05-15;206;51703;165;0;41;0
CT;2020-05-16;119;51822;117;0;2;0
CT;2020-05-17;87;51909;87;0;0;0
CT;2020-05-18;190;52099;155;0;34;1
CT;2020-05-19;205;52304;156;0;49;0
CT;2020-05-20;173;52477;120;0;52;1
CT;2020-05-21;205;52682;139;0;66;0
CT;2020-05-22;266;52948;193;0;72;1
CT;2020-05-23;116;53064;112;0;4;0
CT;2020-05-24;127;53191;126;0;0;1
CT;2020-05-25;216;53407;156;0;60;0
CT;2020-05-26;190;53597;136;0;53;1
CT;2020-05-27;151;53748;107;0;44;0
CT;2020-05-28;205;53953;146;0;59;0
CT;2020-05-29;174;54127;130;0;43;1
CT;2020-05-30;89;54216;85;0;4;0
CT;2020-05-31;50;54266;50;0;0;0
CT;2020-06-01;88;54354;83;0;5;0
CT;2020-06-02;106;54460;91;0;15;0
CT;2020-06-03;125;54585;99;0;26;0
CT;2020-06-04;126;54711;92;0;34;0
CT;2020-06-05;168;54879;145;0;23;0
CT;2020-06-06;65;54944;63;0;2;0
CT;2020-06-07;53;54997;50;0;2;1
CT;2020-06-08;109;55106;94;0;15;0
CT;2020-06-09;86;55192;56;0;30;0
CT;2020-06-10;122;55314;76;0;46;0
CT;2020-06-11;104;55418;63;0;41;0
CT;2020-06-12;105;55523;80;0;25;0
CT;2020-06-13;36;55559;33;0;3;0
CT;2020-06-14;41;55600;40;0;1;0
CT;2020-06-15;80;55680;59;0;21;0
CT;2020-06-16;78;55758;65;0;13;0
CT;2020-06-17;94;55852;78;0;16;0
CT;2020-06-18;102;55954;88;0;14;0
CT;2020-06-19;91;56045;77;0;14;0
CT;2020-06-20;84;56129;82;0;2;0
CT;2020-06-21;73;56202;72;0;1;0
CT;2020-06-22;116;56318;94;0;22;0
CT;2020-06-23;121;56439;100;0;21;0
CT;2020-06-24;90;56529;90;0;0;0
CT;2020-06-25;140;56669;109;0;31;0
CT;2020-06-26;200;56869;162;0;38;0
CT;2020-06-27;116;56985;116;0;0;0
CT;2020-06-28;104;57089;103;0;1;0
CT;2020-06-29;176;57265;159;0;17;0
CT;2020-06-30;181;57446;163;0;16;2
CT;2020-07-01;295;57741;273;0;22;0
CT;2020-07-02;234;57975;212;0;21;1
CT;2020-07-03;273;58248;266;0;7;0
CT;2020-07-04;247;58495;246;0;1;0
CT;2020-07-05;251;58746;251;0;0;0
CT;2020-07-06;368;59114;367;0;0;1
CT;2020-07-07;421;59535;419;0;2;0
CT;2020-07-08;469;60004;469;0;0;0
CT;2020-07-09;487;60491;486;0;0;1
CT;2020-07-10;613;61104;611;0;2;0
CT;2020-07-11;373;61477;373;0;0;0
CT;2020-07-12;406;61883;403;0;0;3
CT;2020-07-13;659;62542;657;0;1;1
CT;2020-07-14;605;63147;603;0;2;0
CT;2020-07-15;803;63950;801;0;0;2
CT;2020-07-16;745;64695;743;0;2;0
CT;2020-07-17;941;65636;940;0;0;1
CT;2020-07-18;708;66344;707;0;0;1
CT;2020-07-19;581;66925;580;0;0;1
CT;2020-07-20;1033;67958;1031;0;2;0
CT;2020-07-21;957;68915;947;0;9;1
CT;2020-07-22;1008;69923;1005;0;2;1
CT;2020-07-23;999;70922;996;0;3;0
CT;2020-07-24;1017;71939;1013;0;3;1
CT;2020-07-25;634;72573;633;0;1;0
CT;2020-07-26;554;73127;554;0;0;0
CT;2020-07-27;993;74120;987;0;6;0
CT;2020-07-28;1017;75137;1017;0;0;0
CT;2020-07-29;1057;76194;1053;0;4;0
CT;2020-07-30;1008;77202;1002;0;6;0
CT;2020-07-31;1145;78347;1140;0;5;0
CT;2020-08-01;694;79041;693;0;1;0
CT;2020-08-02;445;79486;445;0;0;0
CT;2020-08-03;843;80329;843;0;0;0
CT;2020-08-04;956;81285;954;0;2;0
CT;2020-08-05;931;82216;929;0;2;0
CT;2020-08-06;868;83084;866;0;2;0
CT;2020-08-07;1011;84095;1009;0;2;0
CT;2020-08-08;614;84709;614;0;0;0
CT;2020-08-09;434;85143;434;0;0;0
CT;2020-08-10;914;86057;912;0;2;0
CT;2020-08-11;818;86875;815;0;3;0
CT;2020-08-12;851;87726;850;0;1;0
CT;2020-08-13;833;88559;832;0;0;1
CT;2020-08-14;868;89427;866;0;2;0
CT;2020-08-15;460;89887;460;0;0;0
CT;2020-08-16;330;90217;330;0;0;0
EX;2020-01-31;0;0;0;0;0;0
EX;2020-02-01;0;0;0;0;0;0
EX;2020-02-02;2;2;0;2;0;0
EX;2020-02-03;0;2;0;0;0;0
EX;2020-02-04;0;2;0;0;0;0
EX;2020-02-05;0;2;0;0;0;0
EX;2020-02-06;0;2;0;0;0;0
EX;2020-02-07;0;2;0;0;0;0
EX;2020-02-08;1;3;1;0;0;0
EX;2020-02-09;0;3;0;0;0;0
EX;2020-02-10;0;3;0;0;0;0
EX;2020-02-11;0;3;0;0;0;0
EX;2020-02-12;0;3;0;0;0;0
EX;2020-02-13;1;4;0;1;0;0
EX;2020-02-14;1;5;1;0;0;0
EX;2020-02-15;2;7;1;1;0;0
EX;2020-02-16;0;7;0;0;0;0
EX;2020-02-17;1;8;0;1;0;0
EX;2020-02-18;0;8;0;0;0;0
EX;2020-02-19;1;9;1;0;0;0
EX;2020-02-20;1;10;0;1;0;0
EX;2020-02-21;1;11;0;1;0;0
EX;2020-02-22;0;11;0;0;0;0
EX;2020-02-23;0;11;0;0;0;0
EX;2020-02-24;0;11;0;0;0;0
EX;2020-02-25;5;16;2;3;0;0
EX;2020-02-26;1;17;0;1;0;0
EX;2020-02-27;3;20;1;2;0;0
EX;2020-02-28;8;28;4;3;0;1
EX;2020-02-29;4;32;3;1;0;0
EX;2020-03-01;5;37;3;2;0;0
EX;2020-03-02;7;44;6;1;0;0
EX;2020-03-03;9;53;4;5;0;0
EX;2020-03-04;9;62;6;3;0;0
EX;2020-03-05;6;68;5;1;0;0
EX;2020-03-06;20;88;11;9;0;0
EX;2020-03-07;15;103;12;3;0;0
EX;2020-03-08;19;122;12;7;0;0
EX;2020-03-09;38;160;31;7;0;0
EX;2020-03-10;44;204;36;8;0;0
EX;2020-03-11;74;278;57;17;0;0
EX;2020-03-12;87;365;72;15;0;0
EX;2020-03-13;94;459;81;13;0;0
EX;2020-03-14;89;548;71;18;0;0
EX;2020-03-15;86;634;62;24;0;0
EX;2020-03-16;117;751;94;23;0;0
EX;2020-03-17;107;858;95;12;0;0
EX;2020-03-18;127;985;105;21;0;1
EX;2020-03-19;126;1111;103;23;0;0
EX;2020-03-20;173;1284;140;33;0;0
EX;2020-03-21;131;1415;111;20;0;0
EX;2020-03-22;131;1546;116;15;0;0
EX;2020-03-23;245;1791;209;36;0;0
EX;2020-03-24;160;1951;137;23;0;0
EX;2020-03-25;153;2104;121;32;0;0
EX;2020-03-26;138;2242;120;18;0;0
EX;2020-03-27;109;2351;91;18;0;0
EX;2020-03-28;96;2447;72;24;0;0
EX;2020-03-29;62;2509;51;11;0;0
EX;2020-03-30;107;2616;66;41;0;0
EX;2020-03-31;61;2677;37;24;0;0
EX;2020-04-01;134;2811;89;45;0;0
EX;2020-04-02;76;2887;51;25;0;0
EX;2020-04-03;104;2991;65;39;0;0
EX;2020-04-04;75;3066;47;28;0;0
EX;2020-04-05;53;3119;25;28;0;0
EX;2020-04-06;78;3197;37;41;0;0
EX;2020-04-07;72;3269;27;45;0;0
EX;2020-04-08;83;3352;36;47;0;0
EX;2020-04-09;76;3428;21;55;0;0
EX;2020-04-10;98;3526;39;59;0;0
EX;2020-04-11;71;3597;27;44;0;0
EX;2020-04-12;47;3644;21;26;0;0
EX;2020-04-13;68;3712;24;44;0;0
EX;2020-04-14;87;3799;28;59;0;0
EX;2020-04-15;97;3896;25;72;0;0
EX;2020-04-16;69;3965;23;45;1;0
EX;2020-04-17;101;4066;28;73;0;0
EX;2020-04-18;90;4156;18;72;0;0
EX;2020-04-19;48;4204;11;36;1;0
EX;2020-04-20;49;4253;31;18;0;0
EX;2020-04-21;69;4322;16;53;0;0
EX;2020-04-22;85;4407;27;58;0;0
EX;2020-04-23;84;4491;14;70;0;0
EX;2020-04-24;112;4603;16;96;0;0
EX;2020-04-25;87;4690;23;64;0;0
EX;2020-04-26;24;4714;12;12;0;0
EX;2020-04-27;20;4734;10;10;0;0
EX;2020-04-28;26;4760;5;21;0;0
EX;2020-04-29;59;4819;15;44;0;0
EX;2020-04-30;86;4905;13;73;0;0
EX;2020-05-01;97;5002;23;74;0;0
EX;2020-05-02;58;5060;13;45;0;0
EX;2020-05-03;11;5071;5;6;0;0
EX;2020-05-04;20;5091;12;8;0;0
EX;2020-05-05;41;5132;1;40;0;0
EX;2020-05-06;36;5168;5;31;0;0
EX;2020-05-07;50;5218;2;48;0;0
EX;2020-05-08;33;5251;3;29;1;0
EX;2020-05-09;52;5303;2;50;0;0
EX;2020-05-10;5;5308;3;2;0;0
EX;2020-05-11;9;5317;5;4;0;0
EX;2020-05-12;39;5356;7;30;2;0
EX;2020-05-13;38;5394;6;31;1;0
EX;2020-05-14;23;5417;1;22;0;0
EX;2020-05-15;24;5441;2;22;0;0
EX;2020-05-16;21;5462;1;20;0;0
EX;2020-05-17;5;5467;2;3;0;0
EX;2020-05-18;4;5471;3;1;0;0
EX;2020-05-19;11;5482;2;9;0;0
EX;2020-05-20;14;5496;3;11;0;0
EX;2020-05-21;9;5505;2;7;0;0
EX;2020-05-22;11;5516;3;7;1;0
EX;2020-05-23;7;5523;0;7;0;0
EX;2020-05-24;5;5528;1;4;0;0
EX;2020-05-25;5;5533;5;0;0;0
EX;2020-05-26;13;5546;2;11;0;0
EX;2020-05-27;8;5554;2;6;0;0
EX;2020-05-28;0;5554;0;0;0;0
EX;2020-05-29;8;5562;3;5;0;0
EX;2020-05-30;8;5570;2;6;0;0
EX;2020-05-31;2;5572;1;1;0;0
EX;2020-06-01;4;5576;3;1;0;0
EX;2020-06-02;10;5586;4;5;1;0
EX;2020-06-03;6;5592;0;6;0;0
EX;2020-06-04;4;5596;3;1;0;0
EX;2020-06-05;0;5596;0;0;0;0
EX;2020-06-06;0;5596;0;0;0;0
EX;2020-06-07;4;5600;1;3;0;0
EX;2020-06-08;1;5601;1;0;0;0
EX;2020-06-09;2;5603;2;0;0;0
EX;2020-06-10;1;5604;1;0;0;0
EX;2020-06-11;0;5604;0;0;0;0
EX;2020-06-12;1;5605;1;0;0;0
EX;2020-06-13;1;5606;1;0;0;0
EX;2020-06-14;0;5606;0;0;0;0
EX;2020-06-15;5;5611;5;0;0;0
EX;2020-06-16;2;5613;2;0;0;0
EX;2020-06-17;7;5620;7;0;0;0
EX;2020-06-18;4;5624;4;0;0;0
EX;2020-06-19;2;5626;2;0;0;0
EX;2020-06-20;1;5627;1;0;0;0
EX;2020-06-21;5;5632;5;0;0;0
EX;2020-06-22;1;5633;1;0;0;0
EX;2020-06-23;6;5639;5;1;0;0
EX;2020-06-24;1;5640;1;0;0;0
EX;2020-06-25;4;5644;4;0;0;0
EX;2020-06-26;0;5644;0;0;0;0
EX;2020-06-27;5;5649;5;0;0;0
EX;2020-06-28;3;5652;3;0;0;0
EX;2020-06-29;5;5657;5;0;0;0
EX;2020-06-30;7;5664;7;0;0;0
EX;2020-07-01;9;5673;9;0;0;0
EX;2020-07-02;4;5677;4;0;0;0
EX;2020-07-03;8;5685;8;0;0;0
EX;2020-07-04;4;5689;4;0;0;0
EX;2020-07-05;6;5695;6;0;0;0
EX;2020-07-06;2;5697;1;0;1;0
EX;2020-07-07;16;5713;16;0;0;0
EX;2020-07-08;6;5719;6;0;0;0
EX;2020-07-09;23;5742;23;0;0;0
EX;2020-07-10;45;5787;45;0;0;0
EX;2020-07-11;18;5805;18;0;0;0
EX;2020-07-12;12;5817;12;0;0;0
EX;2020-07-13;13;5830;13;0;0;0
EX;2020-07-14;3;5833;3;0;0;0
EX;2020-07-15;13;5846;13;0;0;0
EX;2020-07-16;22;5868;22;0;0;0
EX;2020-07-17;5;5873;5;0;0;0
EX;2020-07-18;5;5878;5;0;0;0
EX;2020-07-19;6;5884;6;0;0;0
EX;2020-07-20;9;5893;9;0;0;0
EX;2020-07-21;17;5910;17;0;0;0
EX;2020-07-22;6;5916;6;0;0;0
EX;2020-07-23;4;5920;4;0;0;0
EX;2020-07-24;11;5931;11;0;0;0
EX;2020-07-25;4;5935;4;0;0;0
EX;2020-07-26;7;5942;7;0;0;0
EX;2020-07-27;9;5951;9;0;0;0
EX;2020-07-28;21;5972;21;0;0;0
EX;2020-07-29;17;5989;17;0;0;0
EX;2020-07-30;20;6009;20;0;0;0
EX;2020-07-31;38;6047;38;0;0;0
EX;2020-08-01;18;6065;18;0;0;0
EX;2020-08-02;21;6086;21;0;0;0
EX;2020-08-03;19;6105;19;0;0;0
EX;2020-08-04;15;6120;15;0;0;0
EX;2020-08-05;34;6154;34;0;0;0
EX;2020-08-06;33;6187;33;0;0;0
EX;2020-08-07;46;6233;46;0;0;0
EX;2020-08-08;19;6252;19;0;0;0
EX;2020-08-09;10;6262;10;0;0;0
EX;2020-08-10;26;6288;26;0;0;0
EX;2020-08-11;34;6322;34;0;0;0
EX;2020-08-12;71;6393;71;0;0;0
EX;2020-08-13;66;6459;66;0;0;0
EX;2020-08-14;42;6501;42;0;0;0
EX;2020-08-15;22;6523;22;0;0;0
EX;2020-08-16;36;6559;36;0;0;0
GA;2020-01-31;0;0;0;0;0;0
GA;2020-02-01;0;0;0;0;0;0
GA;2020-02-02;1;1;1;0;0;0
GA;2020-02-03;1;2;1;0;0;0
GA;2020-02-04;1;3;0;1;0;0
GA;2020-02-05;1;4;0;0;0;1
GA;2020-02-06;0;4;0;0;0;0
GA;2020-02-07;0;4;0;0;0;0
GA;2020-02-08;0;4;0;0;0;0
GA;2020-02-09;0;4;0;0;0;0
GA;2020-02-10;0;4;0;0;0;0
GA;2020-02-11;0;4;0;0;0;0
GA;2020-02-12;0;4;0;0;0;0
GA;2020-02-13;0;4;0;0;0;0
GA;2020-02-14;0;4;0;0;0;0
GA;2020-02-15;0;4;0;0;0;0
GA;2020-02-16;1;5;1;0;0;0
GA;2020-02-17;0;5;0;0;0;0
GA;2020-02-18;1;6;1;0;0;0
GA;2020-02-19;1;7;0;0;0;1
GA;2020-02-20;3;10;3;0;0;0
GA;2020-02-21;0;10;0;0;0;0
GA;2020-02-22;3;13;2;1;0;0
GA;2020-02-23;0;13;0;0;0;0
GA;2020-02-24;1;14;1;0;0;0
GA;2020-02-25;3;17;2;0;0;1
GA;2020-02-26;3;20;3;0;0;0
GA;2020-02-27;7;27;7;0;0;0
GA;2020-02-28;6;33;6;0;0;0
GA;2020-02-29;1;34;1;0;0;0
GA;2020-03-01;7;41;5;2;0;0
GA;2020-03-02;19;60;19;0;0;0
GA;2020-03-03;16;76;16;0;0;0
GA;2020-03-04;14;90;13;0;0;1
GA;2020-03-05;19;109;18;0;0;1
GA;2020-03-06;24;133;24;0;0;0
GA;2020-03-07;33;166;32;0;0;1
GA;2020-03-08;38;204;35;0;0;3
GA;2020-03-09;82;286;80;1;0;1
GA;2020-03-10;118;404;113;2;0;3
GA;2020-03-11;131;535;129;1;0;1
GA;2020-03-12;181;716;181;0;0;0
GA;2020-03-13;241;957;240;0;0;1
GA;2020-03-14;240;1197;238;1;0;1
GA;2020-03-15;270;1467;269;1;0;0
GA;2020-03-16;389;1856;383;3;0;3
GA;2020-03-17;327;2183;323;3;0;1
GA;2020-03-18;309;2492;306;1;0;2
GA;2020-03-19;294;2786;290;4;0;0
GA;2020-03-20;470;3256;462;4;0;4
GA;2020-03-21;276;3532;272;1;0;3
GA;2020-03-22;250;3782;249;1;0;0
GA;2020-03-23;383;4165;377;4;0;2
GA;2020-03-24;295;4460;291;1;0;3
GA;2020-03-25;288;4748;283;4;0;1
GA;2020-03-26;300;5048;295;4;0;1
GA;2020-03-27;306;5354;301;3;0;2
GA;2020-03-28;336;5690;333;1;0;2
GA;2020-03-29;198;5888;196;1;0;1
GA;2020-03-30;282;6170;273;5;0;4
GA;2020-03-31;167;6337;161;4;0;2
GA;2020-04-01;240;6577;233;4;0;3
GA;2020-04-02;266;6843;259;4;0;3
GA;2020-04-03;209;7052;209;0;0;0
GA;2020-04-04;134;7186;133;0;0;1
GA;2020-04-05;118;7304;115;2;0;1
GA;2020-04-06;184;7488;177;6;0;1
GA;2020-04-07;154;7642;148;3;0;3
GA;2020-04-08;150;7792;147;2;0;1
GA;2020-04-09;159;7951;149;8;0;2
GA;2020-04-10;80;8031;71;9;0;0
GA;2020-04-11;66;8097;63;2;0;1
GA;2020-04-12;66;8163;62;3;0;1
GA;2020-04-13;110;8273;103;7;0;0
GA;2020-04-14;100;8373;64;34;0;2
GA;2020-04-15;199;8572;97;100;0;2
GA;2020-04-16;108;8680;69;36;0;3
GA;2020-04-17;98;8778;52;43;0;3
GA;2020-04-18;107;8885;62;45;0;0
GA;2020-04-19;57;8942;47;10;0;0
GA;2020-04-20;89;9031;62;23;0;4
GA;2020-04-21;98;9129;43;48;0;7
GA;2020-04-22;134;9263;48;75;0;11
GA;2020-04-23;124;9387;56;60;0;8
GA;2020-04-24;124;9511;38;79;0;7
GA;2020-04-25;36;9547;25;10;0;1
GA;2020-04-26;26;9573;16;8;0;2
GA;2020-04-27;57;9630;28;24;0;5
GA;2020-04-28;80;9710;20;51;0;9
GA;2020-04-29;113;9823;43;69;0;1
GA;2020-04-30;96;9919;24;58;0;14
GA;2020-05-01;108;10027;19;80;0;9
GA;2020-05-02;84;10111;23;46;0;15
GA;2020-05-03;45;10156;9;36;0;0
GA;2020-05-04;75;10231;13;49;0;13
GA;2020-05-05;133;10364;7;107;0;19
GA;2020-05-06;60;10424;15;39;1;5
GA;2020-05-07;50;10474;10;30;0;10
GA;2020-05-08;43;10517;7;28;0;8
GA;2020-05-09;19;10536;8;9;0;2
GA;2020-05-10;10;10546;7;3;0;0
GA;2020-05-11;11;10557;9;0;0;2
GA;2020-05-12;17;10574;16;0;1;0
GA;2020-05-13;9;10583;9;0;0;0
GA;2020-05-14;7;10590;6;1;0;0
GA;2020-05-15;8;10598;7;0;1;0
GA;2020-05-16;3;10601;3;0;0;0
GA;2020-05-17;2;10603;2;0;0;0
GA;2020-05-18;7;10610;7;0;0;0
GA;2020-05-19;7;10617;7;0;0;0
GA;2020-05-20;6;10623;6;0;0;0
GA;2020-05-21;12;10635;12;0;0;0
GA;2020-05-22;3;10638;3;0;0;0
GA;2020-05-23;8;10646;8;0;0;0
GA;2020-05-24;5;10651;5;0;0;0
GA;2020-05-25;5;10656;4;1;0;0
GA;2020-05-26;2;10658;2;0;0;0
GA;2020-05-27;1;10659;1;0;0;0
GA;2020-05-28;2;10661;2;0;0;0
GA;2020-05-29;5;10666;4;1;0;0
GA;2020-05-30;0;10666;0;0;0;0
GA;2020-05-31;1;10667;1;0;0;0
GA;2020-06-01;1;10668;1;0;0;0
GA;2020-06-02;1;10669;1;0;0;0
GA;2020-06-03;1;10670;1;0;0;0
GA;2020-06-04;2;10672;2;0;0;0
GA;2020-06-05;4;10676;4;0;0;0
GA;2020-06-06;1;10677;1;0;0;0
GA;2020-06-07;2;10679;1;0;0;1
GA;2020-06-08;4;10683;4;0;0;0
GA;2020-06-09;1;10684;1;0;0;0
GA;2020-06-10;1;10685;1;0;0;0
GA;2020-06-11;2;10687;2;0;0;0
GA;2020-06-12;2;10689;2;0;0;0
GA;2020-06-13;0;10689;0;0;0;0
GA;2020-06-14;1;10690;1;0;0;0
GA;2020-06-15;3;10693;3;0;0;0
GA;2020-06-16;1;10694;1;0;0;0
GA;2020-06-17;4;10698;4;0;0;0
GA;2020-06-18;0;10698;0;0;0;0
GA;2020-06-19;1;10699;1;0;0;0
GA;2020-06-20;7;10706;7;0;0;0
GA;2020-06-21;3;10709;3;0;0;0
GA;2020-06-22;0;10709;0;0;0;0
GA;2020-06-23;5;10714;5;0;0;0
GA;2020-06-24;5;10719;5;0;0;0
GA;2020-06-25;8;10727;8;0;0;0
GA;2020-06-26;4;10731;4;0;0;0
GA;2020-06-27;9;10740;8;0;1;0
GA;2020-06-28;11;10751;11;0;0;0
GA;2020-06-29;8;10759;8;0;0;0
GA;2020-06-30;22;10781;22;0;0;0
GA;2020-07-01;12;10793;12;0;0;0
GA;2020-07-02;24;10817;24;0;0;0
GA;2020-07-03;31;10848;31;0;0;0
GA;2020-07-04;17;10865;17;0;0;0
GA;2020-07-05;12;10877;12;0;0;0
GA;2020-07-06;18;10895;18;0;0;0
GA;2020-07-07;35;10930;35;0;0;0
GA;2020-07-08;24;10954;24;0;0;0
GA;2020-07-09;16;10970;16;0;0;0
GA;2020-07-10;7;10977;7;0;0;0
GA;2020-07-11;15;10992;15;0;0;0
GA;2020-07-12;3;10995;3;0;0;0
GA;2020-07-13;8;11003;8;0;0;0
GA;2020-07-14;13;11016;13;0;0;0
GA;2020-07-15;17;11033;17;0;0;0
GA;2020-07-16;11;11044;11;0;0;0
GA;2020-07-17;9;11053;9;0;0;0
GA;2020-07-18;10;11063;10;0;0;0
GA;2020-07-19;13;11076;13;0;0;0
GA;2020-07-20;11;11087;11;0;0;0
GA;2020-07-21;15;11102;15;0;0;0
GA;2020-07-22;21;11123;21;0;0;0
GA;2020-07-23;15;11138;15;0;0;0
GA;2020-07-24;29;11167;29;0;0;0
GA;2020-07-25;19;11186;19;0;0;0
GA;2020-07-26;7;11193;7;0;0;0
GA;2020-07-27;16;11209;16;0;0;0
GA;2020-07-28;15;11224;15;0;0;0
GA;2020-07-29;21;11245;21;0;0;0
GA;2020-07-30;35;11280;35;0;0;0
GA;2020-07-31;38;11318;38;0;0;0
GA;2020-08-01;39;11357;39;0;0;0
GA;2020-08-02;26;11383;26;0;0;0
GA;2020-08-03;57;11440;57;0;0;0
GA;2020-08-04;50;11490;50;0;0;0
GA;2020-08-05;38;11528;38;0;0;0
GA;2020-08-06;101;11629;101;0;0;0
GA;2020-08-07;115;11744;115;0;0;0
GA;2020-08-08;79;11823;79;0;0;0
GA;2020-08-09;61;11884;61;0;0;0
GA;2020-08-10;103;11987;103;0;0;0
GA;2020-08-11;111;12098;111;0;0;0
GA;2020-08-12;141;12239;141;0;0;0
GA;2020-08-13;118;12357;118;0;0;0
GA;2020-08-14;140;12497;140;0;0;0
GA;2020-08-15;161;12658;161;0;0;0
GA;2020-08-16;92;12750;92;0;0;0
IB;2020-01-31;0;0;0;0;0;0
IB;2020-02-01;0;0;0;0;0;0
IB;2020-02-02;0;0;0;0;0;0
IB;2020-02-03;0;0;0;0;0;0
IB;2020-02-04;0;0;0;0;0;0
IB;2020-02-05;0;0;0;0;0;0
IB;2020-02-06;0;0;0;0;0;0
IB;2020-02-07;0;0;0;0;0;0
IB;2020-02-08;0;0;0;0;0;0
IB;2020-02-09;0;0;0;0;0;0
IB;2020-02-10;2;2;2;0;0;0
IB;2020-02-11;0;2;0;0;0;0
IB;2020-02-12;0;2;0;0;0;0
IB;2020-02-13;0;2;0;0;0;0
IB;2020-02-14;2;4;2;0;0;0
IB;2020-02-15;0;4;0;0;0;0
IB;2020-02-16;0;4;0;0;0;0
IB;2020-02-17;0;4;0;0;0;0
IB;2020-02-18;0;4;0;0;0;0
IB;2020-02-19;0;4;0;0;0;0
IB;2020-02-20;1;5;0;1;0;0
IB;2020-02-21;0;5;0;0;0;0
IB;2020-02-22;0;5;0;0;0;0
IB;2020-02-23;0;5;0;0;0;0
IB;2020-02-24;0;5;0;0;0;0
IB;2020-02-25;0;5;0;0;0;0
IB;2020-02-26;1;6;0;1;0;0
IB;2020-02-27;4;10;4;0;0;0
IB;2020-02-28;4;14;1;0;0;3
IB;2020-02-29;2;16;2;0;0;0
IB;2020-03-01;4;20;4;0;0;0
IB;2020-03-02;6;26;6;0;0;0
IB;2020-03-03;7;33;7;0;0;0
IB;2020-03-04;5;38;5;0;0;0
IB;2020-03-05;12;50;12;0;0;0
IB;2020-03-06;10;60;10;0;0;0
IB;2020-03-07;7;67;6;1;0;0
IB;2020-03-08;14;81;12;1;0;1
IB;2020-03-09;17;98;16;1;0;0
IB;2020-03-10;36;134;34;2;0;0
IB;2020-03-11;42;176;41;1;0;0
IB;2020-03-12;42;218;39;2;0;1
IB;2020-03-13;61;279;61;0;0;0
IB;2020-03-14;71;350;68;3;0;0
IB;2020-03-15;85;435;83;1;0;1
IB;2020-03-16;88;523;84;1;0;3
IB;2020-03-17;82;605;79;3;0;0
IB;2020-03-18;81;686;80;1;0;0
IB;2020-03-19;105;791;102;2;0;1
IB;2020-03-20;97;888;95;2;0;0
IB;2020-03-21;62;950;61;1;0;0
IB;2020-03-22;91;1041;90;0;0;1
IB;2020-03-23;82;1123;79;3;0;0
IB;2020-03-24;66;1189;65;1;0;0
IB;2020-03-25;84;1273;80;3;0;1
IB;2020-03-26;73;1346;68;5;0;0
IB;2020-03-27;40;1386;37;2;0;1
IB;2020-03-28;36;1422;32;4;0;0
IB;2020-03-29;37;1459;36;1;0;0
IB;2020-03-30;66;1525;61;3;0;2
IB;2020-03-31;48;1573;45;3;0;0
IB;2020-04-01;84;1657;81;3;0;0
IB;2020-04-02;35;1692;34;1;0;0
IB;2020-04-03;47;1739;43;3;0;1
IB;2020-04-04;25;1764;23;2;0;0
IB;2020-04-05;30;1794;27;2;0;1
IB;2020-04-06;26;1820;21;5;0;0
IB;2020-04-07;19;1839;18;1;0;0
IB;2020-04-08;23;1862;22;1;0;0
IB;2020-04-09;11;1873;8;3;0;0
IB;2020-04-10;21;1894;17;4;0;0
IB;2020-04-11;15;1909;14;1;0;0
IB;2020-04-12;15;1924;15;0;0;0
IB;2020-04-13;15;1939;10;4;0;1
IB;2020-04-14;10;1949;8;2;0;0
IB;2020-04-15;9;1958;5;4;0;0
IB;2020-04-16;14;1972;14;0;0;0
IB;2020-04-17;11;1983;7;3;0;1
IB;2020-04-18;14;1997;12;2;0;0
IB;2020-04-19;10;2007;8;2;0;0
IB;2020-04-20;18;2025;14;3;0;1
IB;2020-04-21;11;2036;7;4;0;0
IB;2020-04-22;8;2044;5;2;0;1
IB;2020-04-23;5;2049;5;0;0;0
IB;2020-04-24;10;2059;9;1;0;0
IB;2020-04-25;11;2070;10;1;0;0
IB;2020-04-26;0;2070;0;0;0;0
IB;2020-04-27;3;2073;3;0;0;0
IB;2020-04-28;5;2078;4;0;0;1
IB;2020-04-29;3;2081;2;1;0;0
IB;2020-04-30;5;2086;5;0;0;0
IB;2020-05-01;10;2096;8;2;0;0
IB;2020-05-02;3;2099;1;2;0;0
IB;2020-05-03;4;2103;3;1;0;0
IB;2020-05-04;1;2104;1;0;0;0
IB;2020-05-05;4;2108;4;0;0;0
IB;2020-05-06;4;2112;4;0;0;0
IB;2020-05-07;2;2114;2;0;0;0
IB;2020-05-08;4;2118;4;0;0;0
IB;2020-05-09;0;2118;0;0;0;0
IB;2020-05-10;7;2125;6;1;0;0
IB;2020-05-11;8;2133;8;0;0;0
IB;2020-05-12;7;2140;7;0;0;0
IB;2020-05-13;10;2150;10;0;0;0
IB;2020-05-14;7;2157;7;0;0;0
IB;2020-05-15;16;2173;15;1;0;0
IB;2020-05-16;0;2173;0;0;0;0
IB;2020-05-17;5;2178;5;0;0;0
IB;2020-05-18;5;2183;5;0;0;0
IB;2020-05-19;12;2195;12;0;0;0
IB;2020-05-20;6;2201;6;0;0;0
IB;2020-05-21;5;2206;5;0;0;0
IB;2020-05-22;3;2209;3;0;0;0
IB;2020-05-23;2;2211;2;0;0;0
IB;2020-05-24;1;2212;1;0;0;0
IB;2020-05-25;3;2215;3;0;0;0
IB;2020-05-26;4;2219;4;0;0;0
IB;2020-05-27;3;2222;3;0;0;0
IB;2020-05-28;13;2235;12;1;0;0
IB;2020-05-29;5;2240;4;1;0;0
IB;2020-05-30;1;2241;1;0;0;0
IB;2020-05-31;2;2243;2;0;0;0
IB;2020-06-01;4;2247;3;1;0;0
IB;2020-06-02;7;2254;7;0;0;0
IB;2020-06-03;3;2257;3;0;0;0
IB;2020-06-04;6;2263;6;0;0;0
IB;2020-06-05;1;2264;1;0;0;0
IB;2020-06-06;2;2266;2;0;0;0
IB;2020-06-07;3;2269;3;0;0;0
IB;2020-06-08;2;2271;2;0;0;0
IB;2020-06-09;1;2272;1;0;0;0
IB;2020-06-10;3;2275;3;0;0;0
IB;2020-06-11;4;2279;4;0;0;0
IB;2020-06-12;6;2285;6;0;0;0
IB;2020-06-13;2;2287;2;0;0;0
IB;2020-06-14;4;2291;4;0;0;0
IB;2020-06-15;3;2294;3;0;0;0
IB;2020-06-16;4;2298;4;0;0;0
IB;2020-06-17;4;2302;4;0;0;0
IB;2020-06-18;5;2307;5;0;0;0
IB;2020-06-19;8;2315;8;0;0;0
IB;2020-06-20;3;2318;3;0;0;0
IB;2020-06-21;1;2319;1;0;0;0
IB;2020-06-22;1;2320;1;0;0;0
IB;2020-06-23;5;2325;5;0;0;0
IB;2020-06-24;3;2328;3;0;0;0
IB;2020-06-25;1;2329;1;0;0;0
IB;2020-06-26;9;2338;9;0;0;0
IB;2020-06-27;5;2343;5;0;0;0
IB;2020-06-28;5;2348;5;0;0;0
IB;2020-06-29;9;2357;9;0;0;0
IB;2020-06-30;3;2360;3;0;0;0
IB;2020-07-01;4;2364;4;0;0;0
IB;2020-07-02;3;2367;3;0;0;0
IB;2020-07-03;4;2371;4;0;0;0
IB;2020-07-04;3;2374;3;0;0;0
IB;2020-07-05;3;2377;3;0;0;0
IB;2020-07-06;4;2381;3;1;0;0
IB;2020-07-07;1;2382;1;0;0;0
IB;2020-07-08;4;2386;4;0;0;0
IB;2020-07-09;6;2392;6;0;0;0
IB;2020-07-10;8;2400;8;0;0;0
IB;2020-07-11;7;2407;7;0;0;0
IB;2020-07-12;4;2411;4;0;0;0
IB;2020-07-13;7;2418;7;0;0;0
IB;2020-07-14;11;2429;11;0;0;0
IB;2020-07-15;13;2442;13;0;0;0
IB;2020-07-16;7;2449;7;0;0;0
IB;2020-07-17;6;2455;6;0;0;0
IB;2020-07-18;7;2462;7;0;0;0
IB;2020-07-19;5;2467;5;0;0;0
IB;2020-07-20;15;2482;15;0;0;0
IB;2020-07-21;14;2496;14;0;0;0
IB;2020-07-22;13;2509;13;0;0;0
IB;2020-07-23;21;2530;21;0;0;0
IB;2020-07-24;26;2556;26;0;0;0
IB;2020-07-25;22;2578;22;0;0;0
IB;2020-07-26;47;2625;47;0;0;0
IB;2020-07-27;40;2665;39;0;0;1
IB;2020-07-28;51;2716;51;0;0;0
IB;2020-07-29;55;2771;55;0;0;0
IB;2020-07-30;76;2847;74;0;0;2
IB;2020-07-31;78;2925;78;0;0;0
IB;2020-08-01;107;3032;107;0;0;0
IB;2020-08-02;94;3126;93;0;0;1
IB;2020-08-03;140;3266;139;0;0;1
IB;2020-08-04;166;3432;164;0;0;2
IB;2020-08-05;152;3584;149;0;0;3
IB;2020-08-06;158;3742;153;0;0;5
IB;2020-08-07;176;3918;169;0;0;7
IB;2020-08-08;171;4089;159;0;0;12
IB;2020-08-09;149;4238;147;0;0;2
IB;2020-08-10;247;4485;247;0;0;0
IB;2020-08-11;182;4667;182;0;0;0
IB;2020-08-12;193;4860;193;0;0;0
IB;2020-08-13;185;5045;185;0;0;0
IB;2020-08-14;120;5165;120;0;0;0
IB;2020-08-15;41;5206;41;0;0;0
IB;2020-08-16;13;5219;13;0;0;0
MC;2020-01-31;0;0;0;0;0;0
MC;2020-02-01;0;0;0;0;0;0
MC;2020-02-02;0;0;0;0;0;0
MC;2020-02-03;0;0;0;0;0;0
MC;2020-02-04;0;0;0;0;0;0
MC;2020-02-05;2;2;0;2;0;0
MC;2020-02-06;0;2;0;0;0;0
MC;2020-02-07;0;2;0;0;0;0
MC;2020-02-08;0;2;0;0;0;0
MC;2020-02-09;0;2;0;0;0;0
MC;2020-02-10;1;3;0;1;0;0
MC;2020-02-11;0;3;0;0;0;0
MC;2020-02-12;0;3;0;0;0;0
MC;2020-02-13;0;3;0;0;0;0
MC;2020-02-14;1;4;0;1;0;0
MC;2020-02-15;0;4;0;0;0;0
MC;2020-02-16;0;4;0;0;0;0
MC;2020-02-17;3;7;0;3;0;0
MC;2020-02-18;1;8;0;1;0;0
MC;2020-02-19;1;9;0;1;0;0
MC;2020-02-20;0;9;0;0;0;0
MC;2020-02-21;0;9;0;0;0;0
MC;2020-02-22;1;10;1;0;0;0
MC;2020-02-23;1;11;1;0;0;0
MC;2020-02-24;2;13;1;1;0;0
MC;2020-02-25;3;16;1;2;0;0
MC;2020-02-26;1;17;0;1;0;0
MC;2020-02-27;1;18;1;0;0;0
MC;2020-02-28;3;21;1;2;0;0
MC;2020-02-29;3;24;2;1;0;0
MC;2020-03-01;5;29;4;1;0;0
MC;2020-03-02;8;37;6;2;0;0
MC;2020-03-03;6;43;3;3;0;0
MC;2020-03-04;11;54;5;6;0;0
MC;2020-03-05;14;68;10;4;0;0
MC;2020-03-06;13;81;10;3;0;0
MC;2020-03-07;20;101;15;5;0;0
MC;2020-03-08;19;120;14;5;0;0
MC;2020-03-09;34;154;24;9;0;1
MC;2020-03-10;65;219;48;16;0;1
MC;2020-03-11;74;293;56;17;0;1
MC;2020-03-12;62;355;40;21;0;1
MC;2020-03-13;104;459;70;33;0;1
MC;2020-03-14;108;567;80;28;0;0
MC;2020-03-15;97;664;70;26;0;1
MC;2020-03-16;130;794;98;32;0;0
MC;2020-03-17;103;897;79;24;0;0
MC;2020-03-18;122;1019;91;30;0;1
MC;2020-03-19;120;1139;80;40;0;0
MC;2020-03-20;122;1261;86;36;0;0
MC;2020-03-21;83;1344;67;15;0;1
MC;2020-03-22;79;1423;64;15;0;0
MC;2020-03-23;128;1551;100;28;0;0
MC;2020-03-24;78;1629;61;17;0;0
MC;2020-03-25;84;1713;65;17;0;2
MC;2020-03-26;47;1760;36;11;0;0
MC;2020-03-27;52;1812;36;14;0;2
MC;2020-03-28;40;1852;29;11;0;0
MC;2020-03-29;35;1887;23;12;0;0
MC;2020-03-30;41;1928;26;15;0;0
MC;2020-03-31;30;1958;23;7;0;0
MC;2020-04-01;28;1986;19;9;0;0
MC;2020-04-02;30;2016;21;9;0;0
MC;2020-04-03;26;2042;14;12;0;0
MC;2020-04-04;22;2064;19;3;0;0
MC;2020-04-05;29;2093;11;18;0;0
MC;2020-04-06;15;2108;6;9;0;0
MC;2020-04-07;10;2118;4;5;0;1
MC;2020-04-08;40;2158;16;24;0;0
MC;2020-04-09;27;2185;5;21;0;1
MC;2020-04-10;12;2197;5;7;0;0
MC;2020-04-11;12;2209;5;7;0;0
MC;2020-04-12;11;2220;4;4;0;3
MC;2020-04-13;7;2227;1;6;0;0
MC;2020-04-14;7;2234;5;2;0;0
MC;2020-04-15;9;2243;5;3;0;1
MC;2020-04-16;2;2245;1;1;0;0
MC;2020-04-17;6;2251;3;3;0;0
MC;2020-04-18;5;2256;0;5;0;0
MC;2020-04-19;4;2260;3;1;0;0
MC;2020-04-20;2;2262;1;1;0;0
MC;2020-04-21;7;2269;2;5;0;0
MC;2020-04-22;8;2277;3;5;0;0
MC;2020-04-23;12;2289;3;9;0;0
MC;2020-04-24;6;2295;0;6;0;0
MC;2020-04-25;3;2298;2;1;0;0
MC;2020-04-26;6;2304;3;3;0;0
MC;2020-04-27;1;2305;0;1;0;0
MC;2020-04-28;16;2321;0;16;0;0
MC;2020-04-29;10;2331;2;8;0;0
MC;2020-04-30;25;2356;1;24;0;0
MC;2020-05-01;8;2364;1;7;0;0
MC;2020-05-02;17;2381;1;16;0;0
MC;2020-05-03;4;2385;1;3;0;0
MC;2020-05-04;2;2387;1;1;0;0
MC;2020-05-05;2;2389;1;1;0;0
MC;2020-05-06;2;2391;2;0;0;0
MC;2020-05-07;2;2393;2;0;0;0
MC;2020-05-08;1;2394;1;0;0;0
MC;2020-05-09;1;2395;1;0;0;0
MC;2020-05-10;1;2396;1;0;0;0
MC;2020-05-11;2;2398;2;0;0;0
MC;2020-05-12;3;2401;3;0;0;0
MC;2020-05-13;5;2406;5;0;0;0
MC;2020-05-14;2;2408;2;0;0;0
MC;2020-05-15;0;2408;0;0;0;0
MC;2020-05-16;1;2409;1;0;0;0
MC;2020-05-17;1;2410;1;0;0;0
MC;2020-05-18;2;2412;2;0;0;0
MC;2020-05-19;2;2414;2;0;0;0
MC;2020-05-20;0;2414;0;0;0;0
MC;2020-05-21;1;2415;1;0;0;0
MC;2020-05-22;1;2416;1;0;0;0
MC;2020-05-23;2;2418;2;0;0;0
MC;2020-05-24;0;2418;0;0;0;0
MC;2020-05-25;0;2418;0;0;0;0
MC;2020-05-26;0;2418;0;0;0;0
MC;2020-05-27;4;2422;4;0;0;0
MC;2020-05-28;2;2424;2;0;0;0
MC;2020-05-29;1;2425;1;0;0;0
MC;2020-05-30;1;2426;1;0;0;0
MC;2020-05-31;0;2426;0;0;0;0
MC;2020-06-01;4;2430;4;0;0;0
MC;2020-06-02;2;2432;2;0;0;0
MC;2020-06-03;2;2434;2;0;0;0
MC;2020-06-04;2;2436;2;0;0;0
MC;2020-06-05;1;2437;1;0;0;0
MC;2020-06-06;3;2440;3;0;0;0
MC;2020-06-07;0;2440;0;0;0;0
MC;2020-06-08;2;2442;2;0;0;0
MC;2020-06-09;2;2444;2;0;0;0
MC;2020-06-10;1;2445;1;0;0;0
MC;2020-06-11;0;2445;0;0;0;0
MC;2020-06-12;0;2445;0;0;0;0
MC;2020-06-13;1;2446;1;0;0;0
MC;2020-06-14;3;2449;3;0;0;0
MC;2020-06-15;2;2451;2;0;0;0
MC;2020-06-16;1;2452;1;0;0;0
MC;2020-06-17;2;2454;2;0;0;0
MC;2020-06-18;2;2456;2;0;0;0
MC;2020-06-19;3;2459;3;0;0;0
MC;2020-06-20;3;2462;3;0;0;0
MC;2020-06-21;4;2466;4;0;0;0
MC;2020-06-22;3;2469;3;0;0;0
MC;2020-06-23;5;2474;5;0;0;0
MC;2020-06-24;7;2481;7;0;0;0
MC;2020-06-25;5;2486;5;0;0;0
MC;2020-06-26;6;2492;6;0;0;0
MC;2020-06-27;6;2498;6;0;0;0
MC;2020-06-28;3;2501;3;0;0;0
MC;2020-06-29;10;2511;10;0;0;0
MC;2020-06-30;3;2514;3;0;0;0
MC;2020-07-01;5;2519;5;0;0;0
MC;2020-07-02;1;2520;1;0;0;0
MC;2020-07-03;2;2522;2;0;0;0
MC;2020-07-04;6;2528;6;0;0;0
MC;2020-07-05;7;2535;7;0;0;0
MC;2020-07-06;7;2542;7;0;0;0
MC;2020-07-07;11;2553;11;0;0;0
MC;2020-07-08;15;2568;15;0;0;0
MC;2020-07-09;4;2572;4;0;0;0
MC;2020-07-10;7;2579;7;0;0;0
MC;2020-07-11;15;2594;15;0;0;0
MC;2020-07-12;11;2605;11;0;0;0
MC;2020-07-13;13;2618;13;0;0;0
MC;2020-07-14;17;2635;17;0;0;0
MC;2020-07-15;29;2664;29;0;0;0
MC;2020-07-16;23;2687;23;0;0;0
MC;2020-07-17;29;2716;29;0;0;0
MC;2020-07-18;20;2736;20;0;0;0
MC;2020-07-19;25;2761;25;0;0;0
MC;2020-07-20;35;2796;35;0;0;0
MC;2020-07-21;47;2843;47;0;0;0
MC;2020-07-22;57;2900;57;0;0;0
MC;2020-07-23;45;2945;45;0;0;0
MC;2020-07-24;53;2998;53;0;0;0
MC;2020-07-25;63;3061;63;0;0;0
MC;2020-07-26;43;3104;43;0;0;0
MC;2020-07-27;58;3162;58;0;0;0
MC;2020-07-28;72;3234;72;0;0;0
MC;2020-07-29;87;3321;87;0;0;0
MC;2020-07-30;62;3383;62;0;0;0
MC;2020-07-31;52;3435;52;0;0;0
MC;2020-08-01;67;3502;67;0;0;0
MC;2020-08-02;58;3560;58;0;0;0
MC;2020-08-03;72;3632;72;0;0;0
MC;2020-08-04;93;3725;93;0;0;0
MC;2020-08-05;61;3786;61;0;0;0
MC;2020-08-06;60;3846;60;0;0;0
MC;2020-08-07;103;3949;103;0;0;0
MC;2020-08-08;78;4027;78;0;0;0
MC;2020-08-09;75;4102;75;0;0;0
MC;2020-08-10;88;4190;88;0;0;0
MC;2020-08-11;94;4284;94;0;0;0
MC;2020-08-12;95;4379;95;0;0;0
MC;2020-08-13;121;4500;121;0;0;0
MC;2020-08-14;78;4578;78;0;0;0
MC;2020-08-15;75;4653;75;0;0;0
MC;2020-08-16;32;4685;32;0;0;0
MD;2020-01-31;4;4689;4;0;0;0
MD;2020-02-01;9;4698;9;0;0;0
MD;2020-02-02;6;4704;6;0;0;0
MD;2020-02-03;7;4711;7;0;0;0
MD;2020-02-04;3;4714;3;0;0;0
MD;2020-02-05;4;4718;4;0;0;0
MD;2020-02-06;4;4722;4;0;0;0
MD;2020-02-07;9;4731;9;0;0;0
MD;2020-02-08;8;4739;8;0;0;0
MD;2020-02-09;2;4741;2;0;0;0
MD;2020-02-10;11;4752;11;0;0;0
MD;2020-02-11;9;4761;9;0;0;0
MD;2020-02-12;9;4770;9;0;0;0
MD;2020-02-13;15;4785;15;0;0;0
MD;2020-02-14;11;4796;11;0;0;0
MD;2020-02-15;13;4809;13;0;0;0
MD;2020-02-16;14;4823;14;0;0;0
MD;2020-02-17;19;4842;19;0;0;0
MD;2020-02-18;14;4856;14;0;0;0
MD;2020-02-19;12;4868;12;0;0;0
MD;2020-02-20;23;4891;23;0;0;0
MD;2020-02-21;27;4918;27;0;0;0
MD;2020-02-22;30;4948;30;0;0;0
MD;2020-02-23;44;4992;44;0;0;0
MD;2020-02-24;57;5049;57;0;0;0
MD;2020-02-25;51;5100;50;0;0;1
MD;2020-02-26;70;5170;70;0;0;0
MD;2020-02-27;95;5265;95;0;0;0
MD;2020-02-28;162;5427;161;0;0;1
MD;2020-02-29;108;5535;107;1;0;0
MD;2020-03-01;324;5859;324;0;0;0
MD;2020-03-02;382;6241;382;0;0;0
MD;2020-03-03;396;6637;396;0;0;0
MD;2020-03-04;464;7101;463;0;0;1
MD;2020-03-05;653;7754;651;0;0;2
MD;2020-03-06;794;8548;789;0;0;5
MD;2020-03-07;844;9392;841;1;0;2
MD;2020-03-08;1054;10446;1053;0;0;1
MD;2020-03-09;1520;11966;1514;0;0;6
MD;2020-03-10;1992;13958;1985;1;0;6
MD;2020-03-11;1975;15933;1974;0;0;1
MD;2020-03-12;2345;18278;2338;0;0;7
MD;2020-03-13;2842;21120;2838;0;0;4
MD;2020-03-14;2565;23685;2554;0;0;11
MD;2020-03-15;2687;26372;2678;0;0;9
MD;2020-03-16;2966;29338;2959;0;0;7
MD;2020-03-17;2792;32130;2789;0;0;3
MD;2020-03-18;2652;34782;2641;0;0;11
MD;2020-03-19;2441;37223;2432;0;0;9
MD;2020-03-20;3112;40335;3107;1;0;4
MD;2020-03-21;1925;42260;1921;1;0;3
MD;2020-03-22;1658;43918;1646;1;0;11
MD;2020-03-23;2134;46052;2129;0;0;5
MD;2020-03-24;1994;48046;1987;1;0;6
MD;2020-03-25;1781;49827;1780;0;0;1
MD;2020-03-26;1552;51379;1549;0;0;3
MD;2020-03-27;1494;52873;1491;0;0;3
MD;2020-03-28;1257;54130;1255;0;0;2
MD;2020-03-29;873;55003;869;1;0;3
MD;2020-03-30;1091;56094;1088;1;0;2
MD;2020-03-31;1077;57171;1076;0;0;1
MD;2020-04-01;1350;58521;1348;0;0;2
MD;2020-04-02;1005;59526;1005;0;0;0
MD;2020-04-03;933;60459;933;0;0;0
MD;2020-04-04;716;61175;714;0;0;2
MD;2020-04-05;635;61810;634;0;0;1
MD;2020-04-06;626;62436;625;0;0;1
MD;2020-04-07;748;63184;746;0;0;2
MD;2020-04-08;681;63865;681;0;0;0
MD;2020-04-09;641;64506;637;0;0;4
MD;2020-04-10;709;65215;707;0;0;2
MD;2020-04-11;575;65790;574;1;0;0
MD;2020-04-12;500;66290;499;0;0;1
MD;2020-04-13;382;66672;379;0;0;3
MD;2020-04-14;497;67169;493;0;0;4
MD;2020-04-15;504;67673;503;0;0;1
MD;2020-04-16;597;68270;596;0;0;1
MD;2020-04-17;389;68659;389;0;0;0
MD;2020-04-18;469;69128;469;0;0;0
MD;2020-04-19;265;69393;264;0;0;1
MD;2020-04-20;281;69674;281;0;0;0
MD;2020-04-21;477;70151;477;0;0;0
MD;2020-04-22;458;70609;457;0;0;1
MD;2020-04-23;369;70978;369;0;0;0
MD;2020-04-24;238;71216;237;0;0;1
MD;2020-04-25;131;71347;131;0;0;0
MD;2020-04-26;124;71471;124;0;0;0
MD;2020-04-27;185;71656;185;0;0;0
MD;2020-04-28;231;71887;231;0;0;0
MD;2020-04-29;213;72100;213;0;0;0
MD;2020-04-30;174;72274;174;0;0;0
MD;2020-05-01;193;72467;193;0;0;0
MD;2020-05-02;166;72633;166;0;0;0
MD;2020-05-03;71;72704;71;0;0;0
MD;2020-05-04;96;72800;96;0;0;0
MD;2020-05-05;58;72858;57;0;0;1
MD;2020-05-06;49;72907;49;0;0;0
MD;2020-05-07;65;72972;64;1;0;0
MD;2020-05-08;89;73061;89;0;0;0
MD;2020-05-09;59;73120;59;0;0;0
MD;2020-05-10;91;73211;91;0;0;0
MD;2020-05-11;159;73370;158;0;1;0
MD;2020-05-12;177;73547;177;0;0;0
MD;2020-05-13;120;73667;119;0;0;1
MD;2020-05-14;133;73800;133;0;0;0
MD;2020-05-15;111;73911;111;0;0;0
MD;2020-05-16;72;73983;72;0;0;0
MD;2020-05-17;79;74062;79;0;0;0
MD;2020-05-18;128;74190;128;0;0;0
MD;2020-05-19;119;74309;119;0;0;0
MD;2020-05-20;98;74407;98;0;0;0
MD;2020-05-21;87;74494;87;0;0;0
MD;2020-05-22;86;74580;86;0;0;0
MD;2020-05-23;83;74663;83;0;0;0
MD;2020-05-24;49;74712;49;0;0;0
MD;2020-05-25;143;74855;143;0;0;0
MD;2020-05-26;123;74978;123;0;0;0
MD;2020-05-27;69;75047;69;0;0;0
MD;2020-05-28;101;75148;101;0;0;0
MD;2020-05-29;112;75260;112;0;0;0
MD;2020-05-30;62;75322;62;0;0;0
MD;2020-05-31;71;75393;71;0;0;0
MD;2020-06-01;128;75521;128;0;0;0
MD;2020-06-02;100;75621;100;0;0;0
MD;2020-06-03;129;75750;129;0;0;0
MD;2020-06-04;96;75846;96;0;0;0
MD;2020-06-05;109;75955;109;0;0;0
MD;2020-06-06;56;76011;56;0;0;0
MD;2020-06-07;46;76057;46;0;0;0
MD;2020-06-08;114;76171;114;0;0;0
MD;2020-06-09;86;76257;86;0;0;0
MD;2020-06-10;93;76350;93;0;0;0
MD;2020-06-11;58;76408;58;0;0;0
MD;2020-06-12;133;76541;133;0;0;0
MD;2020-06-13;22;76563;22;0;0;0
MD;2020-06-14;46;76609;46;0;0;0
MD;2020-06-15;108;76717;108;0;0;0
MD;2020-06-16;56;76773;56;0;0;0
MD;2020-06-17;65;76838;65;0;0;0
MD;2020-06-18;79;76917;79;0;0;0
MD;2020-06-19;63;76980;63;0;0;0
MD;2020-06-20;52;77032;52;0;0;0
MD;2020-06-21;34;77066;34;0;0;0
MD;2020-06-22;40;77106;40;0;0;0
MD;2020-06-23;53;77159;53;0;0;0
MD;2020-06-24;37;77196;37;0;0;0
MD;2020-06-25;55;77251;55;0;0;0
MD;2020-06-26;57;77308;57;0;0;0
MD;2020-06-27;26;77334;26;0;0;0
MD;2020-06-28;23;77357;23;0;0;0
MD;2020-06-29;43;77400;43;0;0;0
MD;2020-06-30;65;77465;65;0;0;0
MD;2020-07-01;49;77514;49;0;0;0
MD;2020-07-02;44;77558;44;0;0;0
MD;2020-07-03;74;77632;74;0;0;0
MD;2020-07-04;30;77662;30;0;0;0
MD;2020-07-05;34;77696;34;0;0;0
MD;2020-07-06;52;77748;52;0;0;0
MD;2020-07-07;48;77796;48;0;0;0
MD;2020-07-08;68;77864;68;0;0;0
MD;2020-07-09;69;77933;69;0;0;0
MD;2020-07-10;66;77999;66;0;0;0
MD;2020-07-11;47;78046;47;0;0;0
MD;2020-07-12;49;78095;49;0;0;0
MD;2020-07-13;96;78191;96;0;0;0
MD;2020-07-14;118;78309;118;0;0;0
MD;2020-07-15;118;78427;118;0;0;0
MD;2020-07-16;94;78521;94;0;0;0
MD;2020-07-17;151;78672;151;0;0;0
MD;2020-07-18;113;78785;113;0;0;0
MD;2020-07-19;104;78889;104;0;0;0
MD;2020-07-20;177;79066;177;0;0;0
MD;2020-07-21;249;79315;249;0;0;0
MD;2020-07-22;236;79551;236;0;0;0
MD;2020-07-23;199;79750;199;0;0;0
MD;2020-07-24;326;80076;326;0;0;0
MD;2020-07-25;296;80372;296;0;0;0
MD;2020-07-26;299;80671;299;0;0;0
MD;2020-07-27;543;81214;543;0;0;0
MD;2020-07-28;698;81912;698;0;0;0
MD;2020-07-29;474;82386;474;0;0;0
MD;2020-07-30;435;82821;435;0;0;0
MD;2020-07-31;578;83399;578;0;0;0
MD;2020-08-01;731;84130;731;0;0;0
MD;2020-08-02;687;84817;687;0;0;0
MD;2020-08-03;1031;85848;1031;0;0;0
MD;2020-08-04;1202;87050;1202;0;0;0
MD;2020-08-05;952;88002;952;0;0;0
MD;2020-08-06;870;88872;870;0;0;0
MD;2020-08-07;1158;90030;1158;0;0;0
MD;2020-08-08;1312;91342;1312;0;0;0
MD;2020-08-09;1253;92595;1253;0;0;0
MD;2020-08-10;1792;94387;1792;0;0;0
MD;2020-08-11;2428;96815;2428;0;0;0
MD;2020-08-12;1354;98169;1354;0;0;0
MD;2020-08-13;1015;99184;1015;0;0;0
MD;2020-08-14;1290;100474;1290;0;0;0
MD;2020-08-15;2173;102647;2173;0;0;0
MD;2020-08-16;1228;103875;1228;0;0;0
ML;2020-01-31;0;0;0;0;0;0
ML;2020-02-01;0;0;0;0;0;0
ML;2020-02-02;0;0;0;0;0;0
ML;2020-02-03;0;0;0;0;0;0
ML;2020-02-04;0;0;0;0;0;0
ML;2020-02-05;0;0;0;0;0;0
ML;2020-02-06;0;0;0;0;0;0
ML;2020-02-07;0;0;0;0;0;0
ML;2020-02-08;0;0;0;0;0;0
ML;2020-02-09;0;0;0;0;0;0
ML;2020-02-10;0;0;0;0;0;0
ML;2020-02-11;0;0;0;0;0;0
ML;2020-02-12;0;0;0;0;0;0
ML;2020-02-13;0;0;0;0;0;0
ML;2020-02-14;0;0;0;0;0;0
ML;2020-02-15;0;0;0;0;0;0
ML;2020-02-16;0;0;0;0;0;0
ML;2020-02-17;0;0;0;0;0;0
ML;2020-02-18;0;0;0;0;0;0
ML;2020-02-19;0;0;0;0;0;0
ML;2020-02-20;0;0;0;0;0;0
ML;2020-02-21;0;0;0;0;0;0
ML;2020-02-22;0;0;0;0;0;0
ML;2020-02-23;0;0;0;0;0;0
ML;2020-02-24;0;0;0;0;0;0
ML;2020-02-25;0;0;0;0;0;0
ML;2020-02-26;0;0;0;0;0;0
ML;2020-02-27;0;0;0;0;0;0
ML;2020-02-28;0;0;0;0;0;0
ML;2020-02-29;0;0;0;0;0;0
ML;2020-03-01;0;0;0;0;0;0
ML;2020-03-02;0;0;0;0;0;0
ML;2020-03-03;0;0;0;0;0;0
ML;2020-03-04;0;0;0;0;0;0
ML;2020-03-05;1;1;1;0;0;0
ML;2020-03-06;1;2;1;0;0;0
ML;2020-03-07;3;5;3;0;0;0
ML;2020-03-08;1;6;1;0;0;0
ML;2020-03-09;2;8;2;0;0;0
ML;2020-03-10;5;13;5;0;0;0
ML;2020-03-11;4;17;3;0;0;1
ML;2020-03-12;3;20;1;1;0;1
ML;2020-03-13;10;30;9;1;0;0
ML;2020-03-14;4;34;3;1;0;0
ML;2020-03-15;3;37;3;0;0;0
ML;2020-03-16;6;43;2;2;1;1
ML;2020-03-17;3;46;3;0;0;0
ML;2020-03-18;6;52;5;0;0;1
ML;2020-03-19;6;58;3;1;0;2
ML;2020-03-20;4;62;4;0;0;0
ML;2020-03-21;3;65;1;0;0;2
ML;2020-03-22;5;70;4;0;0;1
ML;2020-03-23;5;75;4;0;0;1
ML;2020-03-24;1;76;1;0;0;0
ML;2020-03-25;4;80;3;1;0;0
ML;2020-03-26;6;86;5;1;0;0
ML;2020-03-27;5;91;3;0;0;2
ML;2020-03-28;4;95;3;1;0;0
ML;2020-03-29;5;100;4;0;0;1
ML;2020-03-30;3;103;3;0;0;0
ML;2020-03-31;3;106;3;0;0;0
ML;2020-04-01;5;111;5;0;0;0
ML;2020-04-02;3;114;3;0;0;0
ML;2020-04-03;4;118;3;1;0;0
ML;2020-04-04;3;121;2;1;0;0
ML;2020-04-05;1;122;0;1;0;0
ML;2020-04-06;0;122;0;0;0;0
ML;2020-04-07;2;124;2;0;0;0
ML;2020-04-08;0;124;0;0;0;0
ML;2020-04-09;0;124;0;0;0;0
ML;2020-04-10;1;125;1;0;0;0
ML;2020-04-11;0;125;0;0;0;0
ML;2020-04-12;1;126;1;0;0;0
ML;2020-04-13;1;127;1;0;0;0
ML;2020-04-14;0;127;0;0;0;0
ML;2020-04-15;0;127;0;0;0;0
ML;2020-04-16;0;127;0;0;0;0
ML;2020-04-17;0;127;0;0;0;0
ML;2020-04-18;0;127;0;0;0;0
ML;2020-04-19;0;127;0;0;0;0
ML;2020-04-20;2;129;2;0;0;0
ML;2020-04-21;0;129;0;0;0;0
ML;2020-04-22;1;130;1;0;0;0
ML;2020-04-23;0;130;0;0;0;0
ML;2020-04-24;1;131;1;0;0;0
ML;2020-04-25;1;132;1;0;0;0
ML;2020-04-26;0;132;0;0;0;0
ML;2020-04-27;0;132;0;0;0;0
ML;2020-04-28;0;132;0;0;0;0
ML;2020-04-29;1;133;1;0;0;0
ML;2020-04-30;1;134;1;0;0;0
ML;2020-05-01;0;134;0;0;0;0
ML;2020-05-02;0;134;0;0;0;0
ML;2020-05-03;0;134;0;0;0;0
ML;2020-05-04;0;134;0;0;0;0
ML;2020-05-05;0;134;0;0;0;0
ML;2020-05-06;0;134;0;0;0;0
ML;2020-05-07;0;134;0;0;0;0
ML;2020-05-08;0;134;0;0;0;0
ML;2020-05-09;0;134;0;0;0;0
ML;2020-05-10;0;134;0;0;0;0
ML;2020-05-11;0;134;0;0;0;0
ML;2020-05-12;0;134;0;0;0;0
ML;2020-05-13;0;134;0;0;0;0
ML;2020-05-14;0;134;0;0;0;0
ML;2020-05-15;0;134;0;0;0;0
ML;2020-05-16;0;134;0;0;0;0
ML;2020-05-17;0;134;0;0;0;0
ML;2020-05-18;1;135;1;0;0;0
ML;2020-05-19;0;135;0;0;0;0
ML;2020-05-20;0;135;0;0;0;0
ML;2020-05-21;0;135;0;0;0;0
ML;2020-05-22;0;135;0;0;0;0
ML;2020-05-23;0;135;0;0;0;0
ML;2020-05-24;0;135;0;0;0;0
ML;2020-05-25;0;135;0;0;0;0
ML;2020-05-26;0;135;0;0;0;0
ML;2020-05-27;0;135;0;0;0;0
ML;2020-05-28;0;135;0;0;0;0
ML;2020-05-29;0;135;0;0;0;0
ML;2020-05-30;0;135;0;0;0;0
ML;2020-05-31;0;135;0;0;0;0
ML;2020-06-01;1;136;1;0;0;0
ML;2020-06-02;0;136;0;0;0;0
ML;2020-06-03;0;136;0;0;0;0
ML;2020-06-04;0;136;0;0;0;0
ML;2020-06-05;0;136;0;0;0;0
ML;2020-06-06;0;136;0;0;0;0
ML;2020-06-07;0;136;0;0;0;0
ML;2020-06-08;0;136;0;0;0;0
ML;2020-06-09;1;137;1;0;0;0
ML;2020-06-10;0;137;0;0;0;0
ML;2020-06-11;0;137;0;0;0;0
ML;2020-06-12;0;137;0;0;0;0
ML;2020-06-13;0;137;0;0;0;0
ML;2020-06-14;0;137;0;0;0;0
ML;2020-06-15;1;138;1;0;0;0
ML;2020-06-16;0;138;0;0;0;0
ML;2020-06-17;0;138;0;0;0;0
ML;2020-06-18;0;138;0;0;0;0
ML;2020-06-19;0;138;0;0;0;0
ML;2020-06-20;0;138;0;0;0;0
ML;2020-06-21;2;140;2;0;0;0
ML;2020-06-22;0;140;0;0;0;0
ML;2020-06-23;0;140;0;0;0;0
ML;2020-06-24;0;140;0;0;0;0
ML;2020-06-25;0;140;0;0;0;0
ML;2020-06-26;0;140;0;0;0;0
ML;2020-06-27;0;140;0;0;0;0
ML;2020-06-28;0;140;0;0;0;0
ML;2020-06-29;0;140;0;0;0;0
ML;2020-06-30;0;140;0;0;0;0
ML;2020-07-01;0;140;0;0;0;0
ML;2020-07-02;0;140;0;0;0;0
ML;2020-07-03;0;140;0;0;0;0
ML;2020-07-04;0;140;0;0;0;0
ML;2020-07-05;0;140;0;0;0;0
ML;2020-07-06;0;140;0;0;0;0
ML;2020-07-07;0;140;0;0;0;0
ML;2020-07-08;0;140;0;0;0;0
ML;2020-07-09;0;140;0;0;0;0
ML;2020-07-10;0;140;0;0;0;0
ML;2020-07-11;0;140;0;0;0;0
ML;2020-07-12;2;142;2;0;0;0
ML;2020-07-13;0;142;0;0;0;0
ML;2020-07-14;0;142;0;0;0;0
ML;2020-07-15;0;142;0;0;0;0
ML;2020-07-16;0;142;0;0;0;0
ML;2020-07-17;0;142;0;0;0;0
ML;2020-07-18;0;142;0;0;0;0
ML;2020-07-19;0;142;0;0;0;0
ML;2020-07-20;0;142;0;0;0;0
ML;2020-07-21;0;142;0;0;0;0
ML;2020-07-22;0;142;0;0;0;0
ML;2020-07-23;0;142;0;0;0;0
ML;2020-07-24;0;142;0;0;0;0
ML;2020-07-25;0;142;0;0;0;0
ML;2020-07-26;4;146;4;0;0;0
ML;2020-07-27;1;147;1;0;0;0
ML;2020-07-28;1;148;1;0;0;0
ML;2020-07-29;1;149;1;0;0;0
ML;2020-07-30;4;153;4;0;0;0
ML;2020-07-31;0;153;0;0;0;0
ML;2020-08-01;8;161;8;0;0;0
ML;2020-08-02;4;165;4;0;0;0
ML;2020-08-03;4;169;4;0;0;0
ML;2020-08-04;5;174;5;0;0;0
ML;2020-08-05;1;175;1;0;0;0
ML;2020-08-06;2;177;2;0;0;0
ML;2020-08-07;6;183;5;0;0;1
ML;2020-08-08;3;186;3;0;0;0
ML;2020-08-09;5;191;5;0;0;0
ML;2020-08-10;13;204;12;0;0;1
ML;2020-08-11;6;210;4;0;0;2
ML;2020-08-12;8;218;8;0;0;0
ML;2020-08-13;0;218;0;0;0;0
ML;2020-08-14;2;220;2;0;0;0
ML;2020-08-15;6;226;6;0;0;0
ML;2020-08-16;1;227;1;0;0;0
NC;2020-01-31;0;0;0;0;0;0
NC;2020-02-01;0;0;0;0;0;0
NC;2020-02-02;0;0;0;0;0;0
NC;2020-02-03;0;0;0;0;0;0
NC;2020-02-04;1;1;0;1;0;0
NC;2020-02-05;0;1;0;0;0;0
NC;2020-02-06;0;1;0;0;0;0
NC;2020-02-07;0;1;0;0;0;0
NC;2020-02-08;0;1;0;0;0;0
NC;2020-02-09;0;1;0;0;0;0
NC;2020-02-10;1;2;1;0;0;0
NC;2020-02-11;0;2;0;0;0;0
NC;2020-02-12;0;2;0;0;0;0
NC;2020-02-13;0;2;0;0;0;0
NC;2020-02-14;0;2;0;0;0;0
NC;2020-02-15;0;2;0;0;0;0
NC;2020-02-16;0;2;0;0;0;0
NC;2020-02-17;0;2;0;0;0;0
NC;2020-02-18;0;2;0;0;0;0
NC;2020-02-19;0;2;0;0;0;0
NC;2020-02-20;1;3;0;1;0;0
NC;2020-02-21;2;5;1;1;0;0
NC;2020-02-22;1;6;1;0;0;0
NC;2020-02-23;1;7;1;0;0;0
NC;2020-02-24;3;10;3;0;0;0
NC;2020-02-25;4;14;2;2;0;0
NC;2020-02-26;5;19;2;3;0;0
NC;2020-02-27;5;24;4;1;0;0
NC;2020-02-28;3;27;2;1;0;0
NC;2020-02-29;5;32;4;1;0;0
NC;2020-03-01;13;45;8;5;0;0
NC;2020-03-02;15;60;11;4;0;0
NC;2020-03-03;18;78;14;4;0;0
NC;2020-03-04;22;100;18;4;0;0
NC;2020-03-05;28;128;19;9;0;0
NC;2020-03-06;26;154;19;7;0;0
NC;2020-03-07;49;203;42;7;0;0
NC;2020-03-08;51;254;38;13;0;0
NC;2020-03-09;97;351;77;20;0;0
NC;2020-03-10;109;460;84;25;0;0
NC;2020-03-11;130;590;109;21;0;0
NC;2020-03-12;182;772;140;42;0;0
NC;2020-03-13;211;983;138;73;0;0
NC;2020-03-14;177;1160;121;56;0;0
NC;2020-03-15;262;1422;166;96;0;0
NC;2020-03-16;274;1696;156;118;0;0
NC;2020-03-17;267;1963;169;98;0;0
NC;2020-03-18;250;2213;176;74;0;0
NC;2020-03-19;233;2446;153;80;0;0
NC;2020-03-20;328;2774;229;98;0;1
NC;2020-03-21;206;2980;152;54;0;0
NC;2020-03-22;194;3174;141;53;0;0
NC;2020-03-23;242;3416;161;81;0;0
NC;2020-03-24;278;3694;198;80;0;0
NC;2020-03-25;242;3936;182;60;0;0
NC;2020-03-26;167;4103;117;50;0;0
NC;2020-03-27;161;4264;115;46;0;0
NC;2020-03-28;140;4404;108;32;0;0
NC;2020-03-29;96;4500;79;17;0;0
NC;2020-03-30;245;4745;211;34;0;0
NC;2020-03-31;151;4896;125;26;0;0
NC;2020-04-01;233;5129;195;38;0;0
NC;2020-04-02;144;5273;126;18;0;0
NC;2020-04-03;138;5411;126;12;0;0
NC;2020-04-04;88;5499;76;12;0;0
NC;2020-04-05;101;5600;86;15;0;0
NC;2020-04-06;149;5749;132;17;0;0
NC;2020-04-07;118;5867;84;34;0;0
NC;2020-04-08;119;5986;93;26;0;0
NC;2020-04-09;112;6098;79;33;0;0
NC;2020-04-10;106;6204;69;37;0;0
NC;2020-04-11;84;6288;45;39;0;0
NC;2020-04-12;90;6378;59;31;0;0
NC;2020-04-13;87;6465;56;31;0;0
NC;2020-04-14;100;6565;48;52;0;0
NC;2020-04-15;78;6643;35;43;0;0
NC;2020-04-16;61;6704;30;31;0;0
NC;2020-04-17;86;6790;44;42;0;0
NC;2020-04-18;65;6855;39;26;0;0
NC;2020-04-19;46;6901;35;11;0;0
NC;2020-04-20;63;6964;31;32;0;0
NC;2020-04-21;30;6994;11;19;0;0
NC;2020-04-22;53;7047;21;32;0;0
NC;2020-04-23;56;7103;19;37;0;0
NC;2020-04-24;62;7165;21;41;0;0
NC;2020-04-25;39;7204;21;18;0;0
NC;2020-04-26;12;7216;8;4;0;0
NC;2020-04-27;23;7239;20;3;0;0
NC;2020-04-28;32;7271;13;19;0;0
NC;2020-04-29;50;7321;18;32;0;0
NC;2020-04-30;57;7378;16;41;0;0
NC;2020-05-01;72;7450;21;51;0;0
NC;2020-05-02;70;7520;16;54;0;0
NC;2020-05-03;23;7543;10;13;0;0
NC;2020-05-04;20;7563;13;7;0;0
NC;2020-05-05;5;7568;5;0;0;0
NC;2020-05-06;9;7577;7;2;0;0
NC;2020-05-07;2;7579;2;0;0;0
NC;2020-05-08;7;7586;7;0;0;0
NC;2020-05-09;4;7590;3;1;0;0
NC;2020-05-10;5;7595;4;1;0;0
NC;2020-05-11;12;7607;12;0;0;0
NC;2020-05-12;2;7609;2;0;0;0
NC;2020-05-13;9;7618;9;0;0;0
NC;2020-05-14;19;7637;19;0;0;0
NC;2020-05-15;11;7648;11;0;0;0
NC;2020-05-16;4;7652;4;0;0;0
NC;2020-05-17;21;7673;21;0;0;0
NC;2020-05-18;6;7679;6;0;0;0
NC;2020-05-19;9;7688;9;0;0;0
NC;2020-05-20;4;7692;4;0;0;0
NC;2020-05-21;3;7695;3;0;0;0
NC;2020-05-22;6;7701;6;0;0;0
NC;2020-05-23;12;7713;12;0;0;0
NC;2020-05-24;2;7715;2;0;0;0
NC;2020-05-25;5;7720;5;0;0;0
NC;2020-05-26;4;7724;4;0;0;0
NC;2020-05-27;11;7735;11;0;0;0
NC;2020-05-28;9;7744;9;0;0;0
NC;2020-05-29;5;7749;5;0;0;0
NC;2020-05-30;7;7756;7;0;0;0
NC;2020-05-31;3;7759;3;0;0;0
NC;2020-06-01;1;7760;1;0;0;0
NC;2020-06-02;3;7763;3;0;0;0
NC;2020-06-03;6;7769;6;0;0;0
NC;2020-06-04;7;7776;7;0;0;0
NC;2020-06-05;6;7782;6;0;0;0
NC;2020-06-06;1;7783;1;0;0;0
NC;2020-06-07;2;7785;2;0;0;0
NC;2020-06-08;0;7785;0;0;0;0
NC;2020-06-09;5;7790;5;0;0;0
NC;2020-06-10;4;7794;4;0;0;0
NC;2020-06-11;1;7795;1;0;0;0
NC;2020-06-12;1;7796;1;0;0;0
NC;2020-06-13;1;7797;1;0;0;0
NC;2020-06-14;2;7799;2;0;0;0
NC;2020-06-15;4;7803;4;0;0;0
NC;2020-06-16;12;7815;12;0;0;0
NC;2020-06-17;3;7818;3;0;0;0
NC;2020-06-18;6;7824;6;0;0;0
NC;2020-06-19;9;7833;9;0;0;0
NC;2020-06-20;4;7837;4;0;0;0
NC;2020-06-21;15;7852;15;0;0;0
NC;2020-06-22;18;7870;18;0;0;0
NC;2020-06-23;8;7878;8;0;0;0
NC;2020-06-24;10;7888;10;0;0;0
NC;2020-06-25;6;7894;6;0;0;0
NC;2020-06-26;5;7899;5;0;0;0
NC;2020-06-27;7;7906;7;0;0;0
NC;2020-06-28;2;7908;2;0;0;0
NC;2020-06-29;1;7909;1;0;0;0
NC;2020-06-30;3;7912;3;0;0;0
NC;2020-07-01;6;7918;6;0;0;0
NC;2020-07-02;4;7922;4;0;0;0
NC;2020-07-03;7;7929;7;0;0;0
NC;2020-07-04;5;7934;5;0;0;0
NC;2020-07-05;1;7935;1;0;0;0
NC;2020-07-06;12;7947;12;0;0;0
NC;2020-07-07;13;7960;13;0;0;0
NC;2020-07-08;7;7967;7;0;0;0
NC;2020-07-09;29;7996;29;0;0;0
NC;2020-07-10;20;8016;20;0;0;0
NC;2020-07-11;35;8051;35;0;0;0
NC;2020-07-12;23;8074;23;0;0;0
NC;2020-07-13;40;8114;40;0;0;0
NC;2020-07-14;51;8165;51;0;0;0
NC;2020-07-15;43;8208;43;0;0;0
NC;2020-07-16;47;8255;47;0;0;0
NC;2020-07-17;73;8328;73;0;0;0
NC;2020-07-18;78;8406;78;0;0;0
NC;2020-07-19;51;8457;51;0;0;0
NC;2020-07-20;101;8558;101;0;0;0
NC;2020-07-21;119;8677;119;0;0;0
NC;2020-07-22;65;8742;65;0;0;0
NC;2020-07-23;66;8808;66;0;0;0
NC;2020-07-24;56;8864;56;0;0;0
NC;2020-07-25;82;8946;82;0;0;0
NC;2020-07-26;79;9025;79;0;0;0
NC;2020-07-27;51;9076;51;0;0;0
NC;2020-07-28;40;9116;40;0;0;0
NC;2020-07-29;61;9177;61;0;0;0
NC;2020-07-30;52;9229;52;0;0;0
NC;2020-07-31;72;9301;72;0;0;0
NC;2020-08-01;88;9389;88;0;0;0
NC;2020-08-02;83;9472;83;0;0;0
NC;2020-08-03;106;9578;106;0;0;0
NC;2020-08-04;85;9663;85;0;0;0
NC;2020-08-05;82;9745;82;0;0;0
NC;2020-08-06;86;9831;86;0;0;0
NC;2020-08-07;113;9944;113;0;0;0
NC;2020-08-08;91;10035;91;0;0;0
NC;2020-08-09;115;10150;115;0;0;0
NC;2020-08-10;92;10242;92;0;0;0
NC;2020-08-11;117;10359;117;0;0;0
NC;2020-08-12;88;10447;88;0;0;0
NC;2020-08-13;83;10530;83;0;0;0
NC;2020-08-14;71;10601;71;0;0;0
NC;2020-08-15;110;10711;110;0;0;0
NC;2020-08-16;55;10766;55;0;0;0
PV;2020-01-31;0;0;0;0;0;0
PV;2020-02-01;0;0;0;0;0;0
PV;2020-02-02;0;0;0;0;0;0
PV;2020-02-03;0;0;0;0;0;0
PV;2020-02-04;0;0;0;0;0;0
PV;2020-02-05;0;0;0;0;0;0
PV;2020-02-06;0;0;0;0;0;0
PV;2020-02-07;0;0;0;0;0;0
PV;2020-02-08;0;0;0;0;0;0
PV;2020-02-09;1;1;0;0;0;1
PV;2020-02-10;0;1;0;0;0;0
PV;2020-02-11;0;1;0;0;0;0
PV;2020-02-12;2;3;2;0;0;0
PV;2020-02-13;0;3;0;0;0;0
PV;2020-02-14;0;3;0;0;0;0
PV;2020-02-15;3;6;3;0;0;0
PV;2020-02-16;1;7;1;0;0;0
PV;2020-02-17;2;9;2;0;0;0
PV;2020-02-18;0;9;0;0;0;0
PV;2020-02-19;1;10;1;0;0;0
PV;2020-02-20;1;11;1;0;0;0
PV;2020-02-21;3;14;3;0;0;0
PV;2020-02-22;4;18;4;0;0;0
PV;2020-02-23;1;19;1;0;0;0
PV;2020-02-24;6;25;6;0;0;0
PV;2020-02-25;12;37;11;0;0;1
PV;2020-02-26;11;48;11;0;0;0
PV;2020-02-27;14;62;13;0;0;1
PV;2020-02-28;33;95;31;0;0;2
PV;2020-02-29;25;120;25;0;0;0
PV;2020-03-01;47;167;47;0;0;0
PV;2020-03-02;56;223;54;0;0;2
PV;2020-03-03;58;281;57;0;0;1
PV;2020-03-04;69;350;69;0;0;0
PV;2020-03-05;76;426;75;0;0;1
PV;2020-03-06;81;507;80;0;0;1
PV;2020-03-07;92;599;87;0;0;5
PV;2020-03-08;101;700;98;0;0;3
PV;2020-03-09;143;843;140;0;0;3
PV;2020-03-10;227;1070;225;0;0;2
PV;2020-03-11;228;1298;221;0;0;7
PV;2020-03-12;272;1570;264;0;0;8
PV;2020-03-13;428;1998;409;0;0;19
PV;2020-03-14;420;2418;410;0;0;10
PV;2020-03-15;433;2851;418;0;0;15
PV;2020-03-16;600;3451;578;0;0;22
PV;2020-03-17;539;3990;519;0;0;20
PV;2020-03-18;553;4543;544;0;0;9
PV;2020-03-19;467;5010;450;0;0;17
PV;2020-03-20;613;5623;583;0;0;30
PV;2020-03-21;433;6056;423;0;0;10
PV;2020-03-22;394;6450;384;0;0;10
PV;2020-03-23;483;6933;460;0;0;23
PV;2020-03-24;396;7329;377;0;0;19
PV;2020-03-25;410;7739;390;0;0;20
PV;2020-03-26;365;8104;351;0;0;14
PV;2020-03-27;397;8501;386;0;0;11
PV;2020-03-28;290;8791;279;0;0;11
PV;2020-03-29;268;9059;240;0;0;28
PV;2020-03-30;321;9380;304;0;0;17
PV;2020-03-31;267;9647;248;0;0;19
PV;2020-04-01;288;9935;266;0;0;22
PV;2020-04-02;256;10191;239;0;0;17
PV;2020-04-03;330;10521;309;0;0;21
PV;2020-04-04;216;10737;201;0;0;15
PV;2020-04-05;229;10966;218;0;0;11
PV;2020-04-06;298;11264;284;0;0;14
PV;2020-04-07;241;11505;223;0;0;18
PV;2020-04-08;243;11748;218;0;0;25
PV;2020-04-09;215;11963;193;0;0;22
PV;2020-04-10;199;12162;176;0;0;23
PV;2020-04-11;140;12302;124;0;0;16
PV;2020-04-12;153;12455;142;0;0;11
PV;2020-04-13;131;12586;110;0;0;21
PV;2020-04-14;105;12691;90;0;0;15
PV;2020-04-15;109;12800;99;0;0;10
PV;2020-04-16;128;12928;108;0;0;20
PV;2020-04-17;150;13078;132;0;0;18
PV;2020-04-18;108;13186;97;0;0;11
PV;2020-04-19;54;13240;50;0;0;4
PV;2020-04-20;82;13322;78;0;0;4
PV;2020-04-21;78;13400;70;0;0;8
PV;2020-04-22;65;13465;49;0;0;16
PV;2020-04-23;66;13531;58;0;0;8
PV;2020-04-24;97;13628;85;0;0;12
PV;2020-04-25;47;13675;38;0;0;9
PV;2020-04-26;42;13717;31;0;0;11
PV;2020-04-27;31;13748;29;0;0;2
PV;2020-04-28;49;13797;38;0;0;11
PV;2020-04-29;39;13836;31;0;0;8
PV;2020-04-30;33;13869;26;0;0;7
PV;2020-05-01;40;13909;31;0;0;9
PV;2020-05-02;50;13959;41;0;0;9
PV;2020-05-03;35;13994;28;0;0;7
PV;2020-05-04;18;14012;13;0;0;5
PV;2020-05-05;21;14033;19;0;0;2
PV;2020-05-06;24;14057;13;0;0;11
PV;2020-05-07;23;14080;12;0;0;11
PV;2020-05-08;26;14106;18;0;0;8
PV;2020-05-09;20;14126;13;0;0;7
PV;2020-05-10;10;14136;6;0;0;4
PV;2020-05-11;24;14160;23;0;0;1
PV;2020-05-12;22;14182;18;0;0;4
PV;2020-05-13;26;14208;23;0;0;3
PV;2020-05-14;16;14224;12;0;0;4
PV;2020-05-15;14;14238;11;0;0;3
PV;2020-05-16;16;14254;7;0;0;9
PV;2020-05-17;6;14260;6;0;0;0
PV;2020-05-18;16;14276;13;0;0;3
PV;2020-05-19;11;14287;11;0;0;0
PV;2020-05-20;10;14297;8;0;0;2
PV;2020-05-21;11;14308;9;0;0;2
PV;2020-05-22;9;14317;6;0;0;3
PV;2020-05-23;7;14324;6;0;0;1
PV;2020-05-24;3;14327;2;0;0;1
PV;2020-05-25;6;14333;6;0;0;0
PV;2020-05-26;9;14342;8;0;0;1
PV;2020-05-27;2;14344;2;0;0;0
PV;2020-05-28;6;14350;4;0;0;2
PV;2020-05-29;3;14353;2;0;0;1
PV;2020-05-30;7;14360;3;0;0;4
PV;2020-05-31;0;14360;0;0;0;0
PV;2020-06-01;7;14367;7;0;0;0
PV;2020-06-02;12;14379;11;0;0;1
PV;2020-06-03;10;14389;7;0;0;3
PV;2020-06-04;8;14397;6;0;0;2
PV;2020-06-05;11;14408;9;0;0;2
PV;2020-06-06;11;14419;9;0;0;2
PV;2020-06-07;21;14440;13;0;0;8
PV;2020-06-08;15;14455;14;0;0;1
PV;2020-06-09;12;14467;11;0;0;1
PV;2020-06-10;7;14474;7;0;0;0
PV;2020-06-11;10;14484;10;0;0;0
PV;2020-06-12;17;14501;17;0;0;0
PV;2020-06-13;8;14509;8;0;0;0
PV;2020-06-14;6;14515;6;0;0;0
PV;2020-06-15;15;14530;15;0;0;0
PV;2020-06-16;11;14541;11;0;0;0
PV;2020-06-17;8;14549;8;0;0;0
PV;2020-06-18;12;14561;12;0;0;0
PV;2020-06-19;11;14572;11;0;0;0
PV;2020-06-20;4;14576;4;0;0;0
PV;2020-06-21;6;14582;6;0;0;0
PV;2020-06-22;7;14589;7;0;0;0
PV;2020-06-23;5;14594;5;0;0;0
PV;2020-06-24;13;14607;13;0;0;0
PV;2020-06-25;5;14612;5;0;0;0
PV;2020-06-26;10;14622;10;0;0;0
PV;2020-06-27;5;14627;5;0;0;0
PV;2020-06-28;7;14634;7;0;0;0
PV;2020-06-29;8;14642;8;0;0;0
PV;2020-06-30;14;14656;14;0;0;0
PV;2020-07-01;7;14663;7;0;0;0
PV;2020-07-02;8;14671;8;0;0;0
PV;2020-07-03;13;14684;13;0;0;0
PV;2020-07-04;7;14691;7;0;0;0
PV;2020-07-05;17;14708;17;0;0;0
PV;2020-07-06;31;14739;31;0;0;0
PV;2020-07-07;31;14770;31;0;0;0
PV;2020-07-08;37;14807;37;0;0;0
PV;2020-07-09;34;14841;34;0;0;0
PV;2020-07-10;25;14866;25;0;0;0
PV;2020-07-11;41;14907;41;0;0;0
PV;2020-07-12;44;14951;44;0;0;0
PV;2020-07-13;52;15003;52;0;0;0
PV;2020-07-14;80;15083;80;0;0;0
PV;2020-07-15;93;15176;93;0;0;0
PV;2020-07-16;127;15303;127;0;0;0
PV;2020-07-17;102;15405;102;0;0;0
PV;2020-07-18;185;15590;185;0;0;0
PV;2020-07-19;97;15687;97;0;0;0
PV;2020-07-20;111;15798;111;0;0;0
PV;2020-07-21;126;15924;126;0;0;0
PV;2020-07-22;158;16082;158;0;0;0
PV;2020-07-23;119;16201;119;0;0;0
PV;2020-07-24;110;16311;110;0;0;0
PV;2020-07-25;170;16481;170;0;0;0
PV;2020-07-26;170;16651;170;0;0;0
PV;2020-07-27;218;16869;218;0;0;0
PV;2020-07-28;229;17098;229;0;0;0
PV;2020-07-29;201;17299;201;0;0;0
PV;2020-07-30;143;17442;143;0;0;0
PV;2020-07-31;183;17625;183;0;0;0
PV;2020-08-01;216;17841;216;0;0;0
PV;2020-08-02;304;18145;304;0;0;0
PV;2020-08-03;405;18550;405;0;0;0
PV;2020-08-04;364;18914;364;0;0;0
PV;2020-08-05;365;19279;365;0;0;0
PV;2020-08-06;343;19622;343;0;0;0
PV;2020-08-07;263;19885;263;0;0;0
PV;2020-08-08;318;20203;318;0;0;0
PV;2020-08-09;548;20751;548;0;0;0
PV;2020-08-10;500;21251;500;0;0;0
PV;2020-08-11;530;21781;530;0;0;0
PV;2020-08-12;584;22365;584;0;0;0
PV;2020-08-13;347;22712;347;0;0;0
PV;2020-08-14;285;22997;285;0;0;0
PV;2020-08-15;480;23477;480;0;0;0
PV;2020-08-16;549;24026;549;0;0;0
RI;2020-01-31;0;24026;0;0;0;0
RI;2020-02-01;0;24026;0;0;0;0
RI;2020-02-02;0;24026;0;0;0;0
RI;2020-02-03;1;24027;1;0;0;0
RI;2020-02-04;0;24027;0;0;0;0
RI;2020-02-05;0;24027;0;0;0;0
RI;2020-02-06;0;24027;0;0;0;0
RI;2020-02-07;0;24027;0;0;0;0
RI;2020-02-08;0;24027;0;0;0;0
RI;2020-02-09;0;24027;0;0;0;0
RI;2020-02-10;0;24027;0;0;0;0
RI;2020-02-11;0;24027;0;0;0;0
RI;2020-02-12;0;24027;0;0;0;0
RI;2020-02-13;0;24027;0;0;0;0
RI;2020-02-14;0;24027;0;0;0;0
RI;2020-02-15;0;24027;0;0;0;0
RI;2020-02-16;0;24027;0;0;0;0
RI;2020-02-17;0;24027;0;0;0;0
RI;2020-02-18;0;24027;0;0;0;0
RI;2020-02-19;0;24027;0;0;0;0
RI;2020-02-20;0;24027;0;0;0;0
RI;2020-02-21;1;24028;1;0;0;0
RI;2020-02-22;0;24028;0;0;0;0
RI;2020-02-23;1;24029;1;0;0;0
RI;2020-02-24;2;24031;2;0;0;0
RI;2020-02-25;2;24033;2;0;0;0
RI;2020-02-26;4;24037;4;0;0;0
RI;2020-02-27;9;24046;8;1;0;0
RI;2020-02-28;10;24056;10;0;0;0
RI;2020-02-29;13;24069;13;0;0;0
RI;2020-03-01;22;24091;22;0;0;0
RI;2020-03-02;30;24121;29;1;0;0
RI;2020-03-03;28;24149;27;1;0;0
RI;2020-03-04;25;24174;25;0;0;0
RI;2020-03-05;27;24201;27;0;0;0
RI;2020-03-06;45;24246;44;1;0;0
RI;2020-03-07;39;24285;39;0;0;0
RI;2020-03-08;41;24326;41;0;0;0
RI;2020-03-09;60;24386;59;1;0;0
RI;2020-03-10;88;24474;88;0;0;0
RI;2020-03-11;71;24545;68;2;0;1
RI;2020-03-12;74;24619;72;2;0;0
RI;2020-03-13;107;24726;106;1;0;0
RI;2020-03-14;138;24864;136;2;0;0
RI;2020-03-15;111;24975;109;2;0;0
RI;2020-03-16;157;25132;154;3;0;0
RI;2020-03-17;122;25254;117;5;0;0
RI;2020-03-18;143;25397;142;1;0;0
RI;2020-03-19;168;25565;167;1;0;0
RI;2020-03-20;191;25756;190;1;0;0
RI;2020-03-21;133;25889;133;0;0;0
RI;2020-03-22;108;25997;108;0;0;0
RI;2020-03-23;158;26155;155;3;0;0
RI;2020-03-24;118;26273;118;0;0;0
RI;2020-03-25;133;26406;132;1;0;0
RI;2020-03-26;114;26520;112;2;0;0
RI;2020-03-27;129;26649;126;2;0;1
RI;2020-03-28;100;26749;100;0;0;0
RI;2020-03-29;87;26836;85;2;0;0
RI;2020-03-30;117;26953;116;1;0;0
RI;2020-03-31;108;27061;105;3;0;0
RI;2020-04-01;108;27169;107;1;0;0
RI;2020-04-02;100;27269;99;1;0;0
RI;2020-04-03;79;27348;75;4;0;0
RI;2020-04-04;55;27403;53;2;0;0
RI;2020-04-05;36;27439;35;1;0;0
RI;2020-04-06;41;27480;41;0;0;0
RI;2020-04-07;52;27532;51;1;0;0
RI;2020-04-08;45;27577;39;6;0;0
RI;2020-04-09;44;27621;42;2;0;0
RI;2020-04-10;40;27661;39;1;0;0
RI;2020-04-11;25;27686;23;2;0;0
RI;2020-04-12;22;27708;22;0;0;0
RI;2020-04-13;29;27737;25;4;0;0
RI;2020-04-14;24;27761;24;0;0;0
RI;2020-04-15;16;27777;14;2;0;0
RI;2020-04-16;29;27806;28;1;0;0
RI;2020-04-17;25;27831;23;2;0;0
RI;2020-04-18;17;27848;17;0;0;0
RI;2020-04-19;14;27862;14;0;0;0
RI;2020-04-20;9;27871;9;0;0;0
RI;2020-04-21;6;27877;4;2;0;0
RI;2020-04-22;15;27892;14;1;0;0
RI;2020-04-23;13;27905;13;0;0;0
RI;2020-04-24;4;27909;3;1;0;0
RI;2020-04-25;5;27914;5;0;0;0
RI;2020-04-26;4;27918;2;2;0;0
RI;2020-04-27;4;27922;4;0;0;0
RI;2020-04-28;10;27932;10;0;0;0
RI;2020-04-29;5;27937;5;0;0;0
RI;2020-04-30;2;27939;2;0;0;0
RI;2020-05-01;1;27940;1;0;0;0
RI;2020-05-02;2;27942;1;1;0;0
RI;2020-05-03;2;27944;2;0;0;0
RI;2020-05-04;2;27946;2;0;0;0
RI;2020-05-05;0;27946;0;0;0;0
RI;2020-05-06;0;27946;0;0;0;0
RI;2020-05-07;1;27947;1;0;0;0
RI;2020-05-08;1;27948;1;0;0;0
RI;2020-05-09;0;27948;0;0;0;0
RI;2020-05-10;1;27949;1;0;0;0
RI;2020-05-11;4;27953;3;0;1;0
RI;2020-05-12;3;27956;3;0;0;0
RI;2020-05-13;5;27961;4;0;1;0
RI;2020-05-14;4;27965;4;0;0;0
RI;2020-05-15;3;27968;1;0;2;0
RI;2020-05-16;2;27970;2;0;0;0
RI;2020-05-17;0;27970;0;0;0;0
RI;2020-05-18;5;27975;5;0;0;0
RI;2020-05-19;5;27980;5;0;0;0
RI;2020-05-20;4;27984;4;0;0;0
RI;2020-05-21;4;27988;3;0;1;0
RI;2020-05-22;2;27990;2;0;0;0
RI;2020-05-23;2;27992;2;0;0;0
RI;2020-05-24;0;27992;0;0;0;0
RI;2020-05-25;4;27996;3;0;1;0
RI;2020-05-26;0;27996;0;0;0;0
RI;2020-05-27;1;27997;1;0;0;0
RI;2020-05-28;1;27998;1;0;0;0
RI;2020-05-29;2;28000;2;0;0;0
RI;2020-05-30;1;28001;1;0;0;0
RI;2020-05-31;0;28001;0;0;0;0
RI;2020-06-01;3;28004;3;0;0;0
RI;2020-06-02;1;28005;1;0;0;0
RI;2020-06-03;2;28007;2;0;0;0
RI;2020-06-04;1;28008;1;0;0;0
RI;2020-06-05;2;28010;2;0;0;0
RI;2020-06-06;2;28012;2;0;0;0
RI;2020-06-07;1;28013;1;0;0;0
RI;2020-06-08;0;28013;0;0;0;0
RI;2020-06-09;1;28014;1;0;0;0
RI;2020-06-10;0;28014;0;0;0;0
RI;2020-06-11;1;28015;1;0;0;0
RI;2020-06-12;0;28015;0;0;0;0
RI;2020-06-13;2;28017;2;0;0;0
RI;2020-06-14;1;28018;1;0;0;0
RI;2020-06-15;0;28018;0;0;0;0
RI;2020-06-16;1;28019;1;0;0;0
RI;2020-06-17;0;28019;0;0;0;0
RI;2020-06-18;1;28020;1;0;0;0
RI;2020-06-19;0;28020;0;0;0;0
RI;2020-06-20;1;28021;1;0;0;0
RI;2020-06-21;0;28021;0;0;0;0
RI;2020-06-22;0;28021;0;0;0;0
RI;2020-06-23;1;28022;1;0;0;0
RI;2020-06-24;1;28023;1;0;0;0
RI;2020-06-25;0;28023;0;0;0;0
RI;2020-06-26;0;28023;0;0;0;0
RI;2020-06-27;0;28023;0;0;0;0
RI;2020-06-28;1;28024;1;0;0;0
RI;2020-06-29;1;28025;1;0;0;0
RI;2020-06-30;0;28025;0;0;0;0
RI;2020-07-01;0;28025;0;0;0;0
RI;2020-07-02;0;28025;0;0;0;0
RI;2020-07-03;0;28025;0;0;0;0
RI;2020-07-04;0;28025;0;0;0;0
RI;2020-07-05;1;28026;1;0;0;0
RI;2020-07-06;0;28026;0;0;0;0
RI;2020-07-07;3;28029;3;0;0;0
RI;2020-07-08;5;28034;5;0;0;0
RI;2020-07-09;1;28035;1;0;0;0
RI;2020-07-10;10;28045;10;0;0;0
RI;2020-07-11;3;28048;3;0;0;0
RI;2020-07-12;2;28050;2;0;0;0
RI;2020-07-13;4;28054;4;0;0;0
RI;2020-07-14;6;28060;6;0;0;0
RI;2020-07-15;2;28062;2;0;0;0
RI;2020-07-16;9;28071;8;0;0;1
RI;2020-07-17;11;28082;5;0;1;5
RI;2020-07-18;7;28089;5;0;0;2
RI;2020-07-19;0;28089;0;0;0;0
RI;2020-07-20;5;28094;5;0;0;0
RI;2020-07-21;17;28111;17;0;0;0
RI;2020-07-22;9;28120;9;0;0;0
RI;2020-07-23;5;28125;5;0;0;0
RI;2020-07-24;11;28136;11;0;0;0
RI;2020-07-25;1;28137;1;0;0;0
RI;2020-07-26;1;28138;1;0;0;0
RI;2020-07-27;6;28144;6;0;0;0
RI;2020-07-28;9;28153;9;0;0;0
RI;2020-07-29;3;28156;3;0;0;0
RI;2020-07-30;1;28157;1;0;0;0
RI;2020-07-31;7;28164;7;0;0;0
RI;2020-08-01;3;28167;3;0;0;0
RI;2020-08-02;4;28171;4;0;0;0
RI;2020-08-03;9;28180;8;0;1;0
RI;2020-08-04;7;28187;7;0;0;0
RI;2020-08-05;27;28214;27;0;0;0
RI;2020-08-06;15;28229;15;0;0;0
RI;2020-08-07;20;28249;19;0;0;1
RI;2020-08-08;13;28262;13;0;0;0
RI;2020-08-09;21;28283;21;0;0;0
RI;2020-08-10;50;28333;50;0;0;0
RI;2020-08-11;74;28407;74;0;0;0
RI;2020-08-12;56;28463;55;0;0;1
RI;2020-08-13;54;28517;54;0;0;0
RI;2020-08-14;47;28564;47;0;0;0
RI;2020-08-15;38;28602;38;0;0;0
RI;2020-08-16;34;28636;33;0;0;1
VC;2020-01-31;4;28640;3;1;0;0
VC;2020-02-01;1;28641;1;0;0;0
VC;2020-02-02;0;28641;0;0;0;0
VC;2020-02-03;5;28646;1;3;0;1
VC;2020-02-04;1;28647;0;1;0;0
VC;2020-02-05;3;28650;0;3;0;0
VC;2020-02-06;2;28652;2;0;0;0
VC;2020-02-07;1;28653;0;1;0;0
VC;2020-02-08;0;28653;0;0;0;0
VC;2020-02-09;0;28653;0;0;0;0
VC;2020-02-10;4;28657;1;3;0;0
VC;2020-02-11;1;28658;1;0;0;0
VC;2020-02-12;1;28659;1;0;0;0
VC;2020-02-13;2;28661;1;1;0;0
VC;2020-02-14;2;28663;2;0;0;0
VC;2020-02-15;4;28667;4;0;0;0
VC;2020-02-16;1;28668;1;0;0;0
VC;2020-02-17;6;28674;3;3;0;0
VC;2020-02-18;2;28676;1;1;0;0
VC;2020-02-19;2;28678;1;1;0;0
VC;2020-02-20;6;28684;3;3;0;0
VC;2020-02-21;3;28687;2;1;0;0
VC;2020-02-22;2;28689;2;0;0;0
VC;2020-02-23;5;28694;5;0;0;0
VC;2020-02-24;15;28709;13;2;0;0
VC;2020-02-25;10;28719;8;2;0;0
VC;2020-02-26;9;28728;8;1;0;0
VC;2020-02-27;15;28743;15;0;0;0
VC;2020-02-28;28;28771;22;5;0;1
VC;2020-02-29;17;28788;14;3;0;0
VC;2020-03-01;44;28832;34;9;0;1
VC;2020-03-02;46;28878;36;9;0;1
VC;2020-03-03;37;28915;26;9;0;2
VC;2020-03-04;38;28953;34;4;0;0
VC;2020-03-05;56;29009;46;8;0;2
VC;2020-03-06;78;29087;66;12;0;0
VC;2020-03-07;80;29167;64;8;0;8
VC;2020-03-08;118;29285;99;17;0;2
VC;2020-03-09;186;29471;162;21;0;3
VC;2020-03-10;305;29776;266;33;0;6
VC;2020-03-11;294;30070;263;25;0;6
VC;2020-03-12;390;30460;358;31;0;1
VC;2020-03-13;499;30959;444;45;0;10
VC;2020-03-14;496;31455;452;33;0;11
VC;2020-03-15;532;31987;469;55;0;8
VC;2020-03-16;634;32621;570;54;0;10
VC;2020-03-17;559;33180;509;39;0;11
VC;2020-03-18;535;33715;481;43;0;11
VC;2020-03-19;495;34210;456;33;0;6
VC;2020-03-20;573;34783;510;59;0;4
VC;2020-03-21;452;35235;412;32;0;8
VC;2020-03-22;397;35632;362;30;0;5
VC;2020-03-23;485;36117;431;51;0;3
VC;2020-03-24;340;36457;306;27;0;7
VC;2020-03-25;411;36868;359;42;0;10
VC;2020-03-26;309;37177;271;33;0;5
VC;2020-03-27;333;37510;294;27;0;12
VC;2020-03-28;246;37756;218;19;0;9
VC;2020-03-29;217;37973;183;23;0;11
VC;2020-03-30;256;38229;222;25;0;9
VC;2020-03-31;181;38410;151;23;0;7
VC;2020-04-01;240;38650;202;31;1;6
VC;2020-04-02;217;38867;181;31;0;5
VC;2020-04-03;216;39083;190;23;0;3
VC;2020-04-04;142;39225;118;19;0;5
VC;2020-04-05;122;39347;105;12;0;5
VC;2020-04-06;180;39527;137;37;0;6
VC;2020-04-07;171;39698;127;39;0;5
VC;2020-04-08;170;39868;125;41;0;4
VC;2020-04-09;173;40041;117;51;0;5
VC;2020-04-10;141;40182;95;45;0;1
VC;2020-04-11;133;40315;78;50;0;5
VC;2020-04-12;83;40398;67;14;0;2
VC;2020-04-13;99;40497;63;31;0;5
VC;2020-04-14;98;40595;63;29;0;6
VC;2020-04-15;151;40746;72;75;0;4
VC;2020-04-16;130;40876;52;75;0;3
VC;2020-04-17;157;41033;82;72;0;3
VC;2020-04-18;199;41232;52;142;0;5
VC;2020-04-19;71;41303;25;45;0;1
VC;2020-04-20;72;41375;35;34;0;3
VC;2020-04-21;178;41553;50;123;0;5
VC;2020-04-22;156;41709;35;120;0;1
VC;2020-04-23;191;41900;43;142;0;6
VC;2020-04-24;230;42130;40;187;0;3
VC;2020-04-25;106;42236;38;66;0;2
VC;2020-04-26;38;42274;19;18;0;1
VC;2020-04-27;51;42325;20;30;0;1
VC;2020-04-28;120;42445;37;82;0;1
VC;2020-04-29;138;42583;34;103;0;1
VC;2020-04-30;114;42697;19;94;0;1
VC;2020-05-01;95;42792;24;70;1;0
VC;2020-05-02;110;42902;31;76;0;3
VC;2020-05-03;46;42948;15;29;0;2
VC;2020-05-04;28;42976;6;21;0;1
VC;2020-05-05;20;42996;12;8;0;0
VC;2020-05-06;15;43011;12;2;0;1
VC;2020-05-07;13;43024;4;9;0;0
VC;2020-05-08;12;43036;5;7;0;0
VC;2020-05-09;8;43044;7;1;0;0
VC;2020-05-10;8;43052;8;0;0;0
VC;2020-05-11;20;43072;20;0;0;0
VC;2020-05-12;18;43090;18;0;0;0
VC;2020-05-13;12;43102;12;0;0;0
VC;2020-05-14;19;43121;19;0;0;0
VC;2020-05-15;13;43134;13;0;0;0
VC;2020-05-16;8;43142;8;0;0;0
VC;2020-05-17;7;43149;7;0;0;0
VC;2020-05-18;10;43159;10;0;0;0
VC;2020-05-19;12;43171;12;0;0;0
VC;2020-05-20;14;43185;14;0;0;0
VC;2020-05-21;7;43192;7;0;0;0
VC;2020-05-22;17;43209;17;0;0;0
VC;2020-05-23;8;43217;8;0;0;0
VC;2020-05-24;9;43226;9;0;0;0
VC;2020-05-25;5;43231;5;0;0;0
VC;2020-05-26;13;43244;13;0;0;0
VC;2020-05-27;16;43260;16;0;0;0
VC;2020-05-28;9;43269;9;0;0;0
VC;2020-05-29;8;43277;8;0;0;0
VC;2020-05-30;5;43282;5;0;0;0
VC;2020-05-31;7;43289;7;0;0;0
VC;2020-06-01;14;43303;14;0;0;0
VC;2020-06-02;19;43322;19;0;0;0
VC;2020-06-03;11;43333;11;0;0;0
VC;2020-06-04;9;43342;9;0;0;0
VC;2020-06-05;8;43350;8;0;0;0
VC;2020-06-06;8;43358;8;0;0;0
VC;2020-06-07;7;43365;7;0;0;0
VC;2020-06-08;5;43370;5;0;0;0
VC;2020-06-09;8;43378;8;0;0;0
VC;2020-06-10;3;43381;3;0;0;0
VC;2020-06-11;11;43392;11;0;0;0
VC;2020-06-12;11;43403;11;0;0;0
VC;2020-06-13;3;43406;3;0;0;0
VC;2020-06-14;1;43407;1;0;0;0
VC;2020-06-15;11;43418;11;0;0;0
VC;2020-06-16;10;43428;10;0;0;0
VC;2020-06-17;8;43436;8;0;0;0
VC;2020-06-18;8;43444;8;0;0;0
VC;2020-06-19;10;43454;10;0;0;0
VC;2020-06-20;5;43459;5;0;0;0
VC;2020-06-21;10;43469;10;0;0;0
VC;2020-06-22;7;43476;7;0;0;0
VC;2020-06-23;12;43488;12;0;0;0
VC;2020-06-24;6;43494;6;0;0;0
VC;2020-06-25;8;43502;8;0;0;0
VC;2020-06-26;13;43515;13;0;0;0
VC;2020-06-27;13;43528;13;0;0;0
VC;2020-06-28;13;43541;13;0;0;0
VC;2020-06-29;18;43559;18;0;0;0
VC;2020-06-30;18;43577;18;0;0;0
VC;2020-07-01;22;43599;22;0;0;0
VC;2020-07-02;23;43622;23;0;0;0
VC;2020-07-03;14;43636;14;0;0;0
VC;2020-07-04;6;43642;6;0;0;0
VC;2020-07-05;11;43653;11;0;0;0
VC;2020-07-06;20;43673;20;0;0;0
VC;2020-07-07;26;43699;26;0;0;0
VC;2020-07-08;29;43728;29;0;0;0
VC;2020-07-09;28;43756;28;0;0;0
VC;2020-07-10;32;43788;32;0;0;0
VC;2020-07-11;35;43823;35;0;0;0
VC;2020-07-12;17;43840;17;0;0;0
VC;2020-07-13;48;43888;48;0;0;0
VC;2020-07-14;55;43943;55;0;0;0
VC;2020-07-15;77;44020;77;0;0;0
VC;2020-07-16;64;44084;64;0;0;0
VC;2020-07-17;93;44177;93;0;0;0
VC;2020-07-18;91;44268;91;0;0;0
VC;2020-07-19;79;44347;79;0;0;0
VC;2020-07-20;113;44460;113;0;0;0
VC;2020-07-21;126;44586;126;0;0;0
VC;2020-07-22;132;44718;132;0;0;0
VC;2020-07-23;119;44837;119;0;0;0
VC;2020-07-24;148;44985;148;0;0;0
VC;2020-07-25;159;45144;159;0;0;0
VC;2020-07-26;118;45262;118;0;0;0
VC;2020-07-27;181;45443;181;0;0;0
VC;2020-07-28;172;45615;172;0;0;0
VC;2020-07-29;251;45866;251;0;0;0
VC;2020-07-30;221;46087;221;0;0;0
VC;2020-07-31;205;46292;205;0;0;0
VC;2020-08-01;222;46514;222;0;0;0
VC;2020-08-02;172;46686;172;0;0;0
VC;2020-08-03;226;46912;226;0;0;0
VC;2020-08-04;284;47196;284;0;0;0
VC;2020-08-05;296;47492;296;0;0;0
VC;2020-08-06;256;47748;256;0;0;0
VC;2020-08-07;270;48018;270;0;0;0
VC;2020-08-08;253;48271;253;0;0;0
VC;2020-08-09;193;48464;193;0;0;0
VC;2020-08-10;278;48742;278;0;0;0
VC;2020-08-11;271;49013;271;0;0;0
VC;2020-08-12;297;49310;297;0;0;0
VC;2020-08-13;270;49580;270;0;0;0
VC;2020-08-14;300;49880;300;0;0;0
VC;2020-08-15;220;50100;220;0;0;0
VC;2020-08-16;111;50211;111;0;0;0