ccaa_iso;fecha;num_casos;casos_ac;num_casos_prueba_pcr;num_casos_prueba_test_ac;num_casos_prueba_otras;num_casos_prueba_desconocida
AN;2020-01-31;0;0;0;0;0;0
AN;2020-02-01;2;2;2;0;0;0
AN;2020-02-02;2;4;1;1;0;0
AN;2020-02-03;1;5;1;0;0;0
AN;2020-02-04;1;6;0;1;0;0
AN;2020-02-05;1;7;0;1;0;0
AN;2020-02-06;2;9;1;1;0;0
AN;2020-02-07;2;11;2;0;0;0
AN;2020-02-08;0;11;0;0;0;0
AN;2020-02-09;1;12;0;1;0;0
AN;2020-02-10;1;13;1;0;0;0
AN;2020-02-11;1;14;0;1;0;0
AN;2020-02-12;1;15;1;0;0;0
AN;2020-02-13;2;17;1;1;0;0
AN;2020-02-14;1;18;1;0;0;0
AN;2020-02-15;4;22;1;3;0;0
AN;2020-02-16;0;22;0;0;0;0
AN;2020-02-17;2;24;0;2;0;0
AN;2020-02-18;3;27;3;0;0;0
AN;2020-02-19;1;28;0;1;0;0
AN;2020-02-20;8;36;3;5;0;0
AN;2020-02-21;5;41;4;1;0;0
AN;2020-02-22;2;43;2;0;0;0
AN;2020-02-23;2;45;2;0;0;0
AN;2020-02-24;5;50;5;0;0;0
AN;2020-02-25;9;59;9;0;0;0
AN;2020-02-26;9;68;9;0;0;0
AN;2020-02-27;11;79;7;4;0;0
AN;2020-02-28;8;87;7;1;0;0
AN;2020-02-29;9;96;8;1;0;0
AN;2020-03-01;34;130;25;9;0;0
AN;2020-03-02;33;163;31;2;0;0
AN;2020-03-03;42;205;36;6;0;0
AN;2020-03-04;34;239;31;3;0;0
AN;2020-03-05;61;300;55;6;0;0
AN;2020-03-06;73;373;66;7;0;0
AN;2020-03-07;77;450;72;5;0;0
AN;2020-03-08;87;537;78;9;0;0
AN;2020-03-09;169;706;158;11;0;0
AN;2020-03-10;221;927;204;17;0;0
AN;2020-03-11;263;1190;246;17;0;0
AN;2020-03-12;318;1508;301;17;0;0
AN;2020-03-13;487;1995;447;40;0;0
AN;2020-03-14;420;2415;392;28;0;0
AN;2020-03-15;450;2865;409;41;0;0
AN;2020-03-16;572;3437;535;37;0;0
AN;2020-03-17;574;4011;538;36;0;0
AN;2020-03-18;530;4541;493;37;0;0
AN;2020-03-19;555;5096;521;34;0;0
AN;2020-03-20;794;5890;747;47;0;0
AN;2020-03-21;543;6433;517;26;0;0
AN;2020-03-22;522;6955;488;34;0;0
AN;2020-03-23;562;7517;535;27;0;0
AN;2020-03-24;491;8008;462;29;0;0
AN;2020-03-25;521;8529;487;34;0;0
AN;2020-03-26;471;9000;434;36;1;0
AN;2020-03-27;422;9422;391;31;0;0
AN;2020-03-28;324;9746;296;28;0;0
AN;2020-03-29;340;10086;319;21;0;0
AN;2020-03-30;341;10427;302;39;0;0
AN;2020-03-31;253;10680;237;16;0;0
AN;2020-04-01;354;11034;322;32;0;0
AN;2020-04-02;262;11296;215;47;0;0
AN;2020-04-03;202;11498;172;30;0;0
AN;2020-04-04;317;11815;166;151;0;0
AN;2020-04-05;276;12091;159;117;0;0
AN;2020-04-06;186;12277;137;49;0;0
AN;2020-04-07;266;12543;163;103;0;0
AN;2020-04-08;250;12793;131;119;0;0
AN;2020-04-09;137;12930;85;52;0;0
AN;2020-04-10;218;13148;98;120;0;0
AN;2020-04-11;162;13310;94;68;0;0
AN;2020-04-12;128;13438;80;48;0;0
AN;2020-04-13;110;13548;69;41;0;0
AN;2020-04-14;209;13757;57;152;0;0
AN;2020-04-15;216;13973;90;126;0;0
AN;2020-04-16;175;14148;50;125;0;0
AN;2020-04-17;141;14289;63;78;0;0
AN;2020-04-18;135;14424;41;94;0;0
AN;2020-04-19;74;14498;28;46;0;0
AN;2020-04-20;77;14575;37;40;0;0
AN;2020-04-21;154;14729;38;116;0;0
AN;2020-04-22;134;14863;27;107;0;0
AN;2020-04-23;168;15031;35;133;0;0
AN;2020-04-24;169;15200;45;124;0;0
AN;2020-04-25;57;15257;24;33;0;0
AN;2020-04-26;36;15293;15;21;0;0
AN;2020-04-27;45;15338;15;30;0;0
AN;2020-04-28;130;15468;18;112;0;0
AN;2020-04-29;162;15630;32;130;0;0
AN;2020-04-30;119;15749;21;97;1;0
AN;2020-05-01;100;15849;16;84;0;0
AN;2020-05-02;95;15944;15;80;0;0
AN;2020-05-03;27;15971;8;19;0;0
AN;2020-05-04;49;16020;18;31;0;0
AN;2020-05-05;83;16103;22;61;0;0
AN;2020-05-06;39;16142;16;23;0;0
AN;2020-05-07;34;16176;12;21;1;0
AN;2020-05-08;20;16196;11;9;0;0
AN;2020-05-09;22;16218;11;10;0;1
AN;2020-05-10;7;16225;7;0;0;0
AN;2020-05-11;13;16238;9;4;0;0
AN;2020-05-12;16;16254;14;2;0;0
AN;2020-05-13;14;16268;12;2;0;0
AN;2020-05-14;19;16287;15;4;0;0
AN;2020-05-15;11;16298;8;3;0;0
AN;2020-05-16;12;16310;6;5;1;0
AN;2020-05-17;7;16317;6;1;0;0
AN;2020-05-18;4;16321;4;0;0;0
AN;2020-05-19;7;16328;7;0;0;0
AN;2020-05-20;7;16335;7;0;0;0
AN;2020-05-21;11;16346;11;0;0;0
AN;2020-05-22;6;16352;5;1;0;0
AN;2020-05-23;8;16360;8;0;0;0
AN;2020-05-24;10;16370;10;0;0;0
AN;2020-05-25;10;16380;10;0;0;0
AN;2020-05-26;15;16395;15;0;0;0
AN;2020-05-27;11;16406;11;0;0;0
AN;2020-05-28;12;16418;12;0;0;0
AN;2020-05-29;11;16429;11;0;0;0
AN;2020-05-30;16;16445;16;0;0;0
AN;2020-05-31;7;16452;7;0;0;0
AN;2020-06-01;8;16460;8;0;0;0
AN;2020-06-02;3;16463;3;0;0;0
AN;2020-06-03;11;16474;11;0;0;0
AN;2020-06-04;3;16477;3;0;0;0
AN;2020-06-05;4;16481;4;0;0;0
AN;2020-06-06;2;16483;2;0;0;0
AN;2020-06-07;3;16486;3;0;0;0
AN;2020-06-08;3;16489;3;0;0;0
AN;2020-06-09;4;16493;4;0;0;0
AN;2020-06-10;6;16499;6;0;0;0
AN;2020-06-11;3;16502;3;0;0;0
AN;2020-06-12;18;16520;18;0;0;0
AN;2020-06-13;7;16527;7;0;0;0
AN;2020-06-14;9;16536;9;0;0;0
AN;2020-06-15;5;16541;5;0;0;0
AN;2020-06-16;9;16550;9;0;0;0
AN;2020-06-17;13;16563;13;0;0;0
AN;2020-06-18;89;16652;89;0;0;0
AN;2020-06-19;16;16668;16;0;0;0
AN;2020-06-20;20;16688;20;0;0;0
AN;2020-06-21;18;16706;18;0;0;0
AN;2020-06-22;32;16738;32;0;0;0
AN;2020-06-23;16;16754;16;0;0;0
AN;2020-06-24;28;16782;28;0;0;0
AN;2020-06-25;17;16799;17;0;0;0
AN;2020-06-26;10;16809;10;0;0;0
AN;2020-06-27;14;16823;14;0;0;0
AN;2020-06-28;15;16838;15;0;0;0
AN;2020-06-29;19;16857;19;0;0;0
AN;2020-06-30;11;16868;11;0;0;0
AN;2020-07-01;8;16876;8;0;0;0
AN;2020-07-02;8;16884;8;0;0;0
AN;2020-07-03;3;16887;3;0;0;0
AN;2020-07-04;2;16889;2;0;0;0
AN;2020-07-05;0;16889;0;0;0;0
AR;2020-01-31;0;0;0;0;0;0
AR;2020-02-01;0;0;0;0;0;0
AR;2020-02-02;0;0;0;0;0;0
AR;2020-02-03;0;0;0;0;0;0
AR;2020-02-04;0;0;0;0;0;0
AR;2020-02-05;0;0;0;0;0;0
AR;2020-02-06;1;1;1;0;0;0
AR;2020-02-07;0;1;0;0;0;0
AR;2020-02-08;0;1;0;0;0;0
AR;2020-02-09;0;1;0;0;0;0
AR;2020-02-10;0;1;0;0;0;0
AR;2020-02-11;1;2;1;0;0;0
AR;2020-02-12;0;2;0;0;0;0
AR;2020-02-13;1;3;1;0;0;0
AR;2020-02-14;0;3;0;0;0;0
AR;2020-02-15;0;3;0;0;0;0
AR;2020-02-16;1;4;1;0;0;0
AR;2020-02-17;1;5;1;0;0;0
AR;2020-02-18;1;6;1;0;0;0
AR;2020-02-19;0;6;0;0;0;0
AR;2020-02-20;0;6;0;0;0;0
AR;2020-02-21;2;8;2;0;0;0
AR;2020-02-22;3;11;3;0;0;0
AR;2020-02-23;1;12;1;0;0;0
AR;2020-02-24;1;13;1;0;0;0
AR;2020-02-25;2;15;2;0;0;0
AR;2020-02-26;2;17;2;0;0;0
AR;2020-02-27;0;17;0;0;0;0
AR;2020-02-28;4;21;4;0;0;0
AR;2020-02-29;6;27;6;0;0;0
AR;2020-03-01;8;35;8;0;0;0
AR;2020-03-02;14;49;14;0;0;0
AR;2020-03-03;7;56;7;0;0;0
AR;2020-03-04;14;70;14;0;0;0
AR;2020-03-05;10;80;10;0;0;0
AR;2020-03-06;15;95;15;0;0;0
AR;2020-03-07;21;116;21;0;0;0
AR;2020-03-08;36;152;35;0;0;1
AR;2020-03-09;36;188;36;0;0;0
AR;2020-03-10;52;240;52;0;0;0
AR;2020-03-11;66;306;66;0;0;0
AR;2020-03-12;79;385;79;0;0;0
AR;2020-03-13;114;499;113;0;0;1
AR;2020-03-14;107;606;107;0;0;0
AR;2020-03-15;127;733;127;0;0;0
AR;2020-03-16;166;899;166;0;0;0
AR;2020-03-17;157;1056;156;0;1;0
AR;2020-03-18;167;1223;167;0;0;0
AR;2020-03-19;166;1389;166;0;0;0
AR;2020-03-20;236;1625;236;0;0;0
AR;2020-03-21;177;1802;177;0;0;0
AR;2020-03-22;166;1968;166;0;0;0
AR;2020-03-23;268;2236;267;0;0;1
AR;2020-03-24;191;2427;191;0;0;0
AR;2020-03-25;189;2616;187;0;0;2
AR;2020-03-26;166;2782;166;0;0;0
AR;2020-03-27;212;2994;211;0;0;1
AR;2020-03-28;146;3140;146;0;0;0
AR;2020-03-29;137;3277;137;0;0;0
AR;2020-03-30;127;3404;127;0;0;0
AR;2020-03-31;116;3520;116;0;0;0
AR;2020-04-01;157;3677;156;0;0;1
AR;2020-04-02;127;3804;127;0;0;0
AR;2020-04-03;109;3913;109;0;0;0
AR;2020-04-04;94;4007;93;0;0;1
AR;2020-04-05;95;4102;94;0;1;0
AR;2020-04-06;124;4226;124;0;0;0
AR;2020-04-07;108;4334;107;0;0;1
AR;2020-04-08;110;4444;109;0;0;1
AR;2020-04-09;101;4545;88;0;0;13
AR;2020-04-10;84;4629;75;0;0;9
AR;2020-04-11;64;4693;58;0;0;6
AR;2020-04-12;54;4747;51;0;0;3
AR;2020-04-13;83;4830;71;0;0;12
AR;2020-04-14;53;4883;45;0;0;8
AR;2020-04-15;76;4959;61;0;0;15
AR;2020-04-16;63;5022;55;0;0;8
AR;2020-04-17;71;5093;55;0;0;16
AR;2020-04-18;57;5150;55;0;0;2
AR;2020-04-19;43;5193;34;0;0;9
AR;2020-04-20;49;5242;34;0;0;15
AR;2020-04-21;132;5374;36;0;0;96
AR;2020-04-22;101;5475;58;0;0;43
AR;2020-04-23;28;5503;22;0;0;6
AR;2020-04-24;25;5528;20;0;1;4
AR;2020-04-25;33;5561;19;0;0;14
AR;2020-04-26;21;5582;16;0;0;5
AR;2020-04-27;64;5646;23;0;0;41
AR;2020-04-28;126;5772;28;0;1;97
AR;2020-04-29;39;5811;23;0;0;16
AR;2020-04-30;38;5849;25;0;0;13
AR;2020-05-01;15;5864;15;0;0;0
AR;2020-05-02;20;5884;16;0;1;3
AR;2020-05-03;17;5901;15;0;2;0
AR;2020-05-04;30;5931;30;0;0;0
AR;2020-05-05;43;5974;7;0;0;36
AR;2020-05-06;49;6023;10;0;2;37
AR;2020-05-07;32;6055;30;0;0;2
AR;2020-05-08;25;6080;23;0;0;2
AR;2020-05-09;15;6095;15;0;0;0
AR;2020-05-10;10;6105;9;0;0;1
AR;2020-05-11;14;6119;12;0;1;1
AR;2020-05-12;19;6138;17;0;0;2
AR;2020-05-13;23;6161;23;0;0;0
AR;2020-05-14;21;6182;21;0;0;0
AR;2020-05-15;19;6201;19;0;0;0
AR;2020-05-16;19;6220;17;0;0;2
AR;2020-05-17;13;6233;13;0;0;0
AR;2020-05-18;9;6242;9;0;0;0
AR;2020-05-19;14;6256;14;0;0;0
AR;2020-05-20;13;6269;12;0;1;0
AR;2020-05-21;13;6282;13;0;0;0
AR;2020-05-22;13;6295;12;0;1;0
AR;2020-05-23;12;6307;10;0;2;0
AR;2020-05-24;9;6316;9;0;0;0
AR;2020-05-25;9;6325;9;0;0;0
AR;2020-05-26;10;6335;10;0;0;0
AR;2020-05-27;14;6349;13;0;0;1
AR;2020-05-28;4;6353;4;0;0;0
AR;2020-05-29;15;6368;15;0;0;0
AR;2020-05-30;4;6372;3;0;1;0
AR;2020-05-31;9;6381;9;0;0;0
AR;2020-06-01;6;6387;6;0;0;0
AR;2020-06-02;12;6399;11;0;1;0
AR;2020-06-03;13;6412;13;0;0;0
AR;2020-06-04;4;6416;3;0;1;0
AR;2020-06-05;7;6423;7;0;0;0
AR;2020-06-06;4;6427;4;0;0;0
AR;2020-06-07;8;6435;8;0;0;0
AR;2020-06-08;3;6438;3;0;0;0
AR;2020-06-09;4;6442;4;0;0;0
AR;2020-06-10;4;6446;4;0;0;0
AR;2020-06-11;4;6450;4;0;0;0
AR;2020-06-12;12;6462;12;0;0;0
AR;2020-06-13;19;6481;19;0;0;0
AR;2020-06-14;26;6507;25;0;1;0
AR;2020-06-15;36;6543;36;0;0;0
AR;2020-06-16;46;6589;46;0;0;0
AR;2020-06-17;48;6637;48;0;0;0
AR;2020-06-18;52;6689;50;0;1;1
AR;2020-06-19;69;6758;69;0;0;0
AR;2020-06-20;23;6781;23;0;0;0
AR;2020-06-21;52;6833;52;0;0;0
AR;2020-06-22;24;6857;24;0;0;0
AR;2020-06-23;9;6866;9;0;0;0
AR;2020-06-24;31;6897;31;0;0;0
AR;2020-06-25;27;6924;27;0;0;0
AR;2020-06-26;23;6947;23;0;0;0
AR;2020-06-27;34;6981;34;0;0;0
AR;2020-06-28;15;6996;15;0;0;0
AR;2020-06-29;21;7017;21;0;0;0
AR;2020-06-30;27;7044;27;0;0;0
AR;2020-07-01;10;7054;10;0;0;0
AR;2020-07-02;9;7063;9;0;0;0
AR;2020-07-03;11;7074;11;0;0;0
AR;2020-07-04;3;7077;3;0;0;0
AR;2020-07-05;0;7077;0;0;0;0
AS;2020-01-31;0;0;0;0;0;0
AS;2020-02-01;0;0;0;0;0;0
AS;2020-02-02;0;0;0;0;0;0
AS;2020-02-03;0;0;0;0;0;0
AS;2020-02-04;0;0;0;0;0;0
AS;2020-02-05;0;0;0;0;0;0
AS;2020-02-06;0;0;0;0;0;0
AS;2020-02-07;0;0;0;0;0;0
AS;2020-02-08;0;0;0;0;0;0
AS;2020-02-09;0;0;0;0;0;0
AS;2020-02-10;0;0;0;0;0;0
AS;2020-02-11;0;0;0;0;0;0
AS;2020-02-12;0;0;0;0;0;0
AS;2020-02-13;0;0;0;0;0;0
AS;2020-02-14;0;0;0;0;0;0
AS;2020-02-15;0;0;0;0;0;0
AS;2020-02-16;0;0;0;0;0;0
AS;2020-02-17;0;0;0;0;0;0
AS;2020-02-18;0;0;0;0;0;0
AS;2020-02-19;0;0;0;0;0;0
AS;2020-02-20;0;0;0;0;0;0
AS;2020-02-21;0;0;0;0;0;0
AS;2020-02-22;0;0;0;0;0;0
AS;2020-02-23;1;1;1;0;0;0
AS;2020-02-24;0;1;0;0;0;0
AS;2020-02-25;1;2;1;0;0;0
AS;2020-02-26;0;2;0;0;0;0
AS;2020-02-27;0;2;0;0;0;0
AS;2020-02-28;1;3;1;0;0;0
AS;2020-02-29;2;5;2;0;0;0
AS;2020-03-01;2;7;2;0;0;0
AS;2020-03-02;3;10;3;0;0;0
AS;2020-03-03;2;12;2;0;0;0
AS;2020-03-04;2;14;2;0;0;0
AS;2020-03-05;5;19;5;0;0;0
AS;2020-03-06;12;31;12;0;0;0
AS;2020-03-07;12;43;12;0;0;0
AS;2020-03-08;14;57;14;0;0;0
AS;2020-03-09;32;89;32;0;0;0
AS;2020-03-10;52;141;52;0;0;0
AS;2020-03-11;43;184;43;0;0;0
AS;2020-03-12;57;241;57;0;0;0
AS;2020-03-13;70;311;70;0;0;0
AS;2020-03-14;81;392;81;0;0;0
AS;2020-03-15;89;481;89;0;0;0
AS;2020-03-16;106;587;106;0;0;0
AS;2020-03-17;80;667;80;0;0;0
AS;2020-03-18;91;758;91;0;0;0
AS;2020-03-19;101;859;101;0;0;0
AS;2020-03-20;83;942;83;0;0;0
AS;2020-03-21;68;1010;68;0;0;0
AS;2020-03-22;75;1085;75;0;0;0
AS;2020-03-23;70;1155;70;0;0;0
AS;2020-03-24;58;1213;58;0;0;0
AS;2020-03-25;57;1270;57;0;0;0
AS;2020-03-26;77;1347;77;0;0;0
AS;2020-03-27;70;1417;70;0;0;0
AS;2020-03-28;53;1470;53;0;0;0
AS;2020-03-29;40;1510;40;0;0;0
AS;2020-03-30;45;1555;45;0;0;0
AS;2020-03-31;42;1597;42;0;0;0
AS;2020-04-01;29;1626;29;0;0;0
AS;2020-04-02;54;1680;54;0;0;0
AS;2020-04-03;38;1718;38;0;0;0
AS;2020-04-04;45;1763;45;0;0;0
AS;2020-04-05;43;1806;43;0;0;0
AS;2020-04-06;41;1847;41;0;0;0
AS;2020-04-07;45;1892;45;0;0;0
AS;2020-04-08;48;1940;48;0;0;0
AS;2020-04-09;43;1983;43;0;0;0
AS;2020-04-10;57;2040;57;0;0;0
AS;2020-04-11;53;2093;53;0;0;0
AS;2020-04-12;23;2116;23;0;0;0
AS;2020-04-13;32;2148;32;0;0;0
AS;2020-04-14;30;2178;30;0;0;0
AS;2020-04-15;40;2218;40;0;0;0
AS;2020-04-16;12;2230;12;0;0;0
AS;2020-04-17;12;2242;12;0;0;0
AS;2020-04-18;9;2251;9;0;0;0
AS;2020-04-19;6;2257;6;0;0;0
AS;2020-04-20;7;2264;7;0;0;0
AS;2020-04-21;16;2280;16;0;0;0
AS;2020-04-22;8;2288;8;0;0;0
AS;2020-04-23;9;2297;9;0;0;0
AS;2020-04-24;17;2314;17;0;0;0
AS;2020-04-25;3;2317;3;0;0;0
AS;2020-04-26;5;2322;5;0;0;0
AS;2020-04-27;5;2327;5;0;0;0
AS;2020-04-28;10;2337;10;0;0;0
AS;2020-04-29;3;2340;3;0;0;0
AS;2020-04-30;10;2350;10;0;0;0
AS;2020-05-01;2;2352;2;0;0;0
AS;2020-05-02;3;2355;3;0;0;0
AS;2020-05-03;3;2358;3;0;0;0
AS;2020-05-04;4;2362;4;0;0;0
AS;2020-05-05;6;2368;6;0;0;0
AS;2020-05-06;4;2372;4;0;0;0
AS;2020-05-07;3;2375;3;0;0;0
AS;2020-05-08;5;2380;5;0;0;0
AS;2020-05-09;4;2384;4;0;0;0
AS;2020-05-10;1;2385;1;0;0;0
AS;2020-05-11;3;2388;3;0;0;0
AS;2020-05-12;0;2388;0;0;0;0
AS;2020-05-13;2;2390;2;0;0;0
AS;2020-05-14;0;2390;0;0;0;0
AS;2020-05-15;2;2392;2;0;0;0
AS;2020-05-16;1;2393;1;0;0;0
AS;2020-05-17;5;2398;5;0;0;0
AS;2020-05-18;1;2399;1;0;0;0
AS;2020-05-19;0;2399;0;0;0;0
AS;2020-05-20;1;2400;1;0;0;0
AS;2020-05-21;1;2401;1;0;0;0
AS;2020-05-22;1;2402;1;0;0;0
AS;2020-05-23;13;2415;13;0;0;0
AS;2020-05-24;3;2418;3;0;0;0
AS;2020-05-25;3;2421;3;0;0;0
AS;2020-05-26;2;2423;2;0;0;0
AS;2020-05-27;0;2423;0;0;0;0
AS;2020-05-28;0;2423;0;0;0;0
AS;2020-05-29;1;2424;1;0;0;0
AS;2020-05-30;3;2427;3;0;0;0
AS;2020-05-31;1;2428;1;0;0;0
AS;2020-06-01;1;2429;1;0;0;0
AS;2020-06-02;0;2429;0;0;0;0
AS;2020-06-03;0;2429;0;0;0;0
AS;2020-06-04;0;2429;0;0;0;0
AS;2020-06-05;4;2433;4;0;0;0
AS;2020-06-06;2;2435;2;0;0;0
AS;2020-06-07;0;2435;0;0;0;0
AS;2020-06-08;0;2435;0;0;0;0
AS;2020-06-09;0;2435;0;0;0;0
AS;2020-06-10;0;2435;0;0;0;0
AS;2020-06-11;0;2435;0;0;0;0
AS;2020-06-12;0;2435;0;0;0;0
AS;2020-06-13;0;2435;0;0;0;0
AS;2020-06-14;0;2435;0;0;0;0
AS;2020-06-15;0;2435;0;0;0;0
AS;2020-06-16;0;2435;0;0;0;0
AS;2020-06-17;0;2435;0;0;0;0
AS;2020-06-18;0;2435;0;0;0;0
AS;2020-06-19;0;2435;0;0;0;0
AS;2020-06-20;0;2435;0;0;0;0
AS;2020-06-21;0;2435;0;0;0;0
AS;2020-06-22;0;2435;0;0;0;0
AS;2020-06-23;0;2435;0;0;0;0
AS;2020-06-24;0;2435;0;0;0;0
AS;2020-06-25;0;2435;0;0;0;0
AS;2020-06-26;0;2435;0;0;0;0
AS;2020-06-27;0;2435;0;0;0;0
AS;2020-06-28;0;2435;0;0;0;0
AS;2020-06-29;0;2435;0;0;0;0
AS;2020-06-30;0;2435;0;0;0;0
AS;2020-07-01;1;2436;1;0;0;0
AS;2020-07-02;0;2436;0;0;0;0
AS;2020-07-03;0;2436;0;0;0;0
AS;2020-07-04;0;2436;0;0;0;0
AS;2020-07-05;0;2436;0;0;0;0
CB;2020-01-31;0;0;0;0;0;0
CB;2020-02-01;0;0;0;0;0;0
CB;2020-02-02;0;0;0;0;0;0
CB;2020-02-03;0;0;0;0;0;0
CB;2020-02-04;0;0;0;0;0;0
CB;2020-02-05;0;0;0;0;0;0
CB;2020-02-06;0;0;0;0;0;0
CB;2020-02-07;0;0;0;0;0;0
CB;2020-02-08;0;0;0;0;0;0
CB;2020-02-09;0;0;0;0;0;0
CB;2020-02-10;0;0;0;0;0;0
CB;2020-02-11;0;0;0;0;0;0
CB;2020-02-12;0;0;0;0;0;0
CB;2020-02-13;0;0;0;0;0;0
CB;2020-02-14;0;0;0;0;0;0
CB;2020-02-15;0;0;0;0;0;0
CB;2020-02-16;0;0;0;0;0;0
CB;2020-02-17;0;0;0;0;0;0
CB;2020-02-18;0;0;0;0;0;0
CB;2020-02-19;0;0;0;0;0;0
CB;2020-02-20;0;0;0;0;0;0
CB;2020-02-21;0;0;0;0;0;0
CB;2020-02-22;0;0;0;0;0;0
CB;2020-02-23;1;1;1;0;0;0
CB;2020-02-24;0;1;0;0;0;0
CB;2020-02-25;8;9;8;0;0;0
CB;2020-02-26;0;9;0;0;0;0
CB;2020-02-27;0;9;0;0;0;0
CB;2020-02-28;0;9;0;0;0;0
CB;2020-02-29;1;10;1;0;0;0
CB;2020-03-01;1;11;1;0;0;0
CB;2020-03-02;0;11;0;0;0;0
CB;2020-03-03;0;11;0;0;0;0
CB;2020-03-04;0;11;0;0;0;0
CB;2020-03-05;0;11;0;0;0;0
CB;2020-03-06;9;20;9;0;0;0
CB;2020-03-07;12;32;12;0;0;0
CB;2020-03-08;17;49;17;0;0;0
CB;2020-03-09;9;58;9;0;0;0
CB;2020-03-10;3;61;3;0;0;0
CB;2020-03-11;17;78;17;0;0;0
CB;2020-03-12;36;114;36;0;0;0
CB;2020-03-13;54;168;54;0;0;0
CB;2020-03-14;59;227;59;0;0;0
CB;2020-03-15;68;295;68;0;0;0
CB;2020-03-16;71;366;71;0;0;0
CB;2020-03-17;76;442;76;0;0;0
CB;2020-03-18;89;531;89;0;0;0
CB;2020-03-19;177;708;177;0;0;0
CB;2020-03-20;143;851;143;0;0;0
CB;2020-03-21;99;950;99;0;0;0
CB;2020-03-22;84;1034;84;0;0;0
CB;2020-03-23;87;1121;87;0;0;0
CB;2020-03-24;57;1178;57;0;0;0
CB;2020-03-25;57;1235;57;0;0;0
CB;2020-03-26;39;1274;39;0;0;0
CB;2020-03-27;74;1348;74;0;0;0
CB;2020-03-28;68;1416;68;0;0;0
CB;2020-03-29;39;1455;39;0;0;0
CB;2020-03-30;27;1482;27;0;0;0
CB;2020-03-31;33;1515;33;0;0;0
CB;2020-04-01;72;1587;72;0;0;0
CB;2020-04-02;53;1640;53;0;0;0
CB;2020-04-03;34;1674;34;0;0;0
CB;2020-04-04;62;1736;62;0;0;0
CB;2020-04-05;25;1761;25;0;0;0
CB;2020-04-06;28;1789;27;1;0;0
CB;2020-04-07;13;1802;13;0;0;0
CB;2020-04-08;26;1828;26;0;0;0
CB;2020-04-09;23;1851;23;0;0;0
CB;2020-04-10;29;1880;29;0;0;0
CB;2020-04-11;24;1904;24;0;0;0
CB;2020-04-12;46;1950;46;0;0;0
CB;2020-04-13;35;1985;35;0;0;0
CB;2020-04-14;14;1999;14;0;0;0
CB;2020-04-15;17;2016;17;0;0;0
CB;2020-04-16;18;2034;18;0;0;0
CB;2020-04-17;26;2060;26;0;0;0
CB;2020-04-18;13;2073;13;0;0;0
CB;2020-04-19;15;2088;15;0;0;0
CB;2020-04-20;24;2112;24;0;0;0
CB;2020-04-21;10;2122;10;0;0;0
CB;2020-04-22;26;2148;26;0;0;0
CB;2020-04-23;26;2174;26;0;0;0
CB;2020-04-24;13;2187;13;0;0;0
CB;2020-04-25;12;2199;12;0;0;0
CB;2020-04-26;4;2203;4;0;0;0
CB;2020-04-27;2;2205;2;0;0;0
CB;2020-04-28;5;2210;5;0;0;0
CB;2020-04-29;4;2214;4;0;0;0
CB;2020-04-30;12;2226;12;0;0;0
CB;2020-05-01;16;2242;16;0;0;0
CB;2020-05-02;0;2242;0;0;0;0
CB;2020-05-03;3;2245;3;0;0;0
CB;2020-05-04;1;2246;1;0;0;0
CB;2020-05-05;10;2256;10;0;0;0
CB;2020-05-06;5;2261;5;0;0;0
CB;2020-05-07;0;2261;0;0;0;0
CB;2020-05-08;2;2263;2;0;0;0
CB;2020-05-09;1;2264;1;0;0;0
CB;2020-05-10;5;2269;4;1;0;0
CB;2020-05-11;3;2272;2;1;0;0
CB;2020-05-12;2;2274;1;1;0;0
CB;2020-05-13;2;2276;2;0;0;0
CB;2020-05-14;2;2278;2;0;0;0
CB;2020-05-15;5;2283;5;0;0;0
CB;2020-05-16;1;2284;1;0;0;0
CB;2020-05-17;1;2285;1;0;0;0
CB;2020-05-18;2;2287;2;0;0;0
CB;2020-05-19;2;2289;2;0;0;0
CB;2020-05-20;2;2291;2;0;0;0
CB;2020-05-21;2;2293;2;0;0;0
CB;2020-05-22;1;2294;1;0;0;0
CB;2020-05-23;3;2297;3;0;0;0
CB;2020-05-24;1;2298;1;0;0;0
CB;2020-05-25;1;2299;1;0;0;0
CB;2020-05-26;2;2301;2;0;0;0
CB;2020-05-27;1;2302;1;0;0;0
CB;2020-05-28;1;2303;1;0;0;0
CB;2020-05-29;2;2305;2;0;0;0
CB;2020-05-30;1;2306;1;0;0;0
CB;2020-05-31;1;2307;1;0;0;0
CB;2020-06-01;4;2311;4;0;0;0
CB;2020-06-02;1;2312;1;0;0;0
CB;2020-06-03;0;2312;0;0;0;0
CB;2020-06-04;0;2312;0;0;0;0
CB;2020-06-05;5;2317;5;0;0;0
CB;2020-06-06;2;2319;2;0;0;0
CB;2020-06-07;4;2323;4;0;0;0
CB;2020-06-08;1;2324;1;0;0;0
CB;2020-06-09;1;2325;1;0;0;0
CB;2020-06-10;3;2328;2;1;0;0
CB;2020-06-11;2;2330;2;0;0;0
CB;2020-06-12;1;2331;1;0;0;0
CB;2020-06-13;0;2331;0;0;0;0
CB;2020-06-14;2;2333;2;0;0;0
CB;2020-06-15;2;2335;2;0;0;0
CB;2020-06-16;0;2335;0;0;0;0
CB;2020-06-17;2;2337;2;0;0;0
CB;2020-06-18;4;2341;4;0;0;0
CB;2020-06-19;0;2341;0;0;0;0
CB;2020-06-20;5;2346;5;0;0;0
CB;2020-06-21;2;2348;2;0;0;0
CB;2020-06-22;1;2349;1;0;0;0
CB;2020-06-23;1;2350;1;0;0;0
CB;2020-06-24;3;2353;3;0;0;0
CB;2020-06-25;1;2354;1;0;0;0
CB;2020-06-26;1;2355;1;0;0;0
CB;2020-06-27;3;2358;3;0;0;0
CB;2020-06-28;0;2358;0;0;0;0
CB;2020-06-29;1;2359;1;0;0;0
CB;2020-06-30;0;2359;0;0;0;0
CB;2020-07-01;0;2359;0;0;0;0
CB;2020-07-02;0;2359;0;0;0;0
CB;2020-07-03;0;2359;0;0;0;0
CB;2020-07-04;0;2359;0;0;0;0
CB;2020-07-05;0;2359;0;0;0;0
CE;2020-01-31;0;0;0;0;0;0
CE;2020-02-01;0;0;0;0;0;0
CE;2020-02-02;0;0;0;0;0;0
CE;2020-02-03;0;0;0;0;0;0
CE;2020-02-04;0;0;0;0;0;0
CE;2020-02-05;1;1;0;1;0;0
CE;2020-02-06;0;1;0;0;0;0
CE;2020-02-07;0;1;0;0;0;0
CE;2020-02-08;0;1;0;0;0;0
CE;2020-02-09;0;1;0;0;0;0
CE;2020-02-10;0;1;0;0;0;0
CE;2020-02-11;0;1;0;0;0;0
CE;2020-02-12;0;1;0;0;0;0
CE;2020-02-13;1;2;0;1;0;0
CE;2020-02-14;0;2;0;0;0;0
CE;2020-02-15;0;2;0;0;0;0
CE;2020-02-16;0;2;0;0;0;0
CE;2020-02-17;0;2;0;0;0;0
CE;2020-02-18;0;2;0;0;0;0
CE;2020-02-19;0;2;0;0;0;0
CE;2020-02-20;0;2;0;0;0;0
CE;2020-02-21;0;2;0;0;0;0
CE;2020-02-22;0;2;0;0;0;0
CE;2020-02-23;0;2;0;0;0;0
CE;2020-02-24;0;2;0;0;0;0
CE;2020-02-25;0;2;0;0;0;0
CE;2020-02-26;0;2;0;0;0;0
CE;2020-02-27;0;2;0;0;0;0
CE;2020-02-28;0;2;0;0;0;0
CE;2020-02-29;0;2;0;0;0;0
CE;2020-03-01;0;2;0;0;0;0
CE;2020-03-02;0;2;0;0;0;0
CE;2020-03-03;2;4;0;1;0;1
CE;2020-03-04;0;4;0;0;0;0
CE;2020-03-05;1;5;0;1;0;0
CE;2020-03-06;0;5;0;0;0;0
CE;2020-03-07;0;5;0;0;0;0
CE;2020-03-08;1;6;0;0;0;1
CE;2020-03-09;1;7;0;1;0;0
CE;2020-03-10;1;8;0;0;0;1
CE;2020-03-11;3;11;0;1;0;2
CE;2020-03-12;1;12;0;0;0;1
CE;2020-03-13;6;18;1;0;0;5
CE;2020-03-14;4;22;0;1;0;3
CE;2020-03-15;2;24;0;1;0;1
CE;2020-03-16;6;30;1;1;0;4
CE;2020-03-17;5;35;0;1;0;4
CE;2020-03-18;6;41;0;2;0;4
CE;2020-03-19;5;46;0;2;0;3
CE;2020-03-20;7;53;0;1;0;6
CE;2020-03-21;7;60;0;1;0;6
CE;2020-03-22;7;67;0;0;0;7
CE;2020-03-23;9;76;0;6;0;3
CE;2020-03-24;8;84;0;0;0;8
CE;2020-03-25;9;93;1;2;0;6
CE;2020-03-26;5;98;1;1;0;3
CE;2020-03-27;2;100;0;1;0;1
CE;2020-03-28;5;105;0;0;0;5
CE;2020-03-29;7;112;0;0;0;7
CE;2020-03-30;5;117;0;1;0;4
CE;2020-03-31;2;119;0;0;0;2
CE;2020-04-01;8;127;0;6;0;2
CE;2020-04-02;2;129;0;1;0;1
CE;2020-04-03;2;131;0;1;0;1
CE;2020-04-04;2;133;0;0;0;2
CE;2020-04-05;2;135;0;0;0;2
CE;2020-04-06;3;138;1;0;0;2
CE;2020-04-07;2;140;0;0;0;2
CE;2020-04-08;1;141;0;1;0;0
CE;2020-04-09;3;144;1;1;0;1
CE;2020-04-10;1;145;0;0;0;1
CE;2020-04-11;2;147;0;2;0;0
CE;2020-04-12;0;147;0;0;0;0
CE;2020-04-13;2;149;0;1;0;1
CE;2020-04-14;0;149;0;0;0;0
CE;2020-04-15;0;149;0;0;0;0
CE;2020-04-16;1;150;1;0;0;0
CE;2020-04-17;1;151;0;1;0;0
CE;2020-04-18;1;152;0;1;0;0
CE;2020-04-19;0;152;0;0;0;0
CE;2020-04-20;1;153;1;0;0;0
CE;2020-04-21;2;155;0;2;0;0
CE;2020-04-22;3;158;1;2;0;0
CE;2020-04-23;3;161;0;3;0;0
CE;2020-04-24;1;162;0;1;0;0
CE;2020-04-25;1;163;1;0;0;0
CE;2020-04-26;0;163;0;0;0;0
CE;2020-04-27;1;164;1;0;0;0
CE;2020-04-28;2;166;1;1;0;0
CE;2020-04-29;4;170;4;0;0;0
CE;2020-04-30;0;170;0;0;0;0
CE;2020-05-01;1;171;1;0;0;0
CE;2020-05-02;2;173;2;0;0;0
CE;2020-05-03;0;173;0;0;0;0
CE;2020-05-04;0;173;0;0;0;0
CE;2020-05-05;1;174;1;0;0;0
CE;2020-05-06;2;176;2;0;0;0
CE;2020-05-07;1;177;1;0;0;0
CE;2020-05-08;0;177;0;0;0;0
CE;2020-05-09;0;177;0;0;0;0
CE;2020-05-10;0;177;0;0;0;0
CE;2020-05-11;0;177;0;0;0;0
CE;2020-05-12;2;179;2;0;0;0
CE;2020-05-13;0;179;0;0;0;0
CE;2020-05-14;1;180;1;0;0;0
CE;2020-05-15;0;180;0;0;0;0
CE;2020-05-16;1;181;1;0;0;0
CE;2020-05-17;0;181;0;0;0;0
CE;2020-05-18;1;182;1;0;0;0
CE;2020-05-19;7;189;7;0;0;0
CE;2020-05-20;0;189;0;0;0;0
CE;2020-05-21;3;192;3;0;0;0
CE;2020-05-22;4;196;4;0;0;0
CE;2020-05-23;5;201;5;0;0;0
CE;2020-05-24;2;203;2;0;0;0
CE;2020-05-25;2;205;2;0;0;0
CE;2020-05-26;5;210;5;0;0;0
CE;2020-05-27;0;210;0;0;0;0
CE;2020-05-28;5;215;5;0;0;0
CE;2020-05-29;2;217;2;0;0;0
CE;2020-05-30;3;220;3;0;0;0
CE;2020-05-31;0;220;0;0;0;0
CE;2020-06-01;0;220;0;0;0;0
CE;2020-06-02;2;222;2;0;0;0
CE;2020-06-03;0;222;0;0;0;0
CE;2020-06-04;0;222;0;0;0;0
CE;2020-06-05;0;222;0;0;0;0
CE;2020-06-06;0;222;0;0;0;0
CE;2020-06-07;0;222;0;0;0;0
CE;2020-06-08;0;222;0;0;0;0
CE;2020-06-09;0;222;0;0;0;0
CE;2020-06-10;0;222;0;0;0;0
CE;2020-06-11;0;222;0;0;0;0
CE;2020-06-12;0;222;0;0;0;0
CE;2020-06-13;0;222;0;0;0;0
CE;2020-06-14;0;222;0;0;0;0
CE;2020-06-15;0;222;0;0;0;0
CE;2020-06-16;0;222;0;0;0;0
CE;2020-06-17;0;222;0;0;0;0
CE;2020-06-18;0;222;0;0;0;0
CE;2020-06-19;0;222;0;0;0;0
CE;2020-06-20;0;222;0;0;0;0
CE;2020-06-21;0;222;0;0;0;0
CE;2020-06-22;0;222;0;0;0;0
CE;2020-06-23;0;222;0;0;0;0
CE;2020-06-24;0;222;0;0;0;0
CE;2020-06-25;0;222;0;0;0;0
CE;2020-06-26;0;222;0;0;0;0
CE;2020-06-27;0;222;0;0;0;0
CE;2020-06-28;0;222;0;0;0;0
CE;2020-06-29;0;222;0;0;0;0
CE;2020-06-30;0;222;0;0;0;0
CE;2020-07-01;0;222;0;0;0;0
CE;2020-07-02;0;222;0;0;0;0
CE;2020-07-03;0;222;0;0;0;0
CE;2020-07-04;0;222;0;0;0;0
CE;2020-07-05;0;222;0;0;0;0
CL;2020-01-31;0;0;0;0;0;0
CL;2020-02-01;0;0;0;0;0;0
CL;2020-02-02;0;0;0;0;0;0
CL;2020-02-03;1;1;0;1;0;0
CL;2020-02-04;1;2;1;0;0;0
CL;2020-02-05;1;3;1;0;0;0
CL;2020-02-06;0;3;0;0;0;0
CL;2020-02-07;1;4;1;0;0;0
CL;2020-02-08;0;4;0;0;0;0
CL;2020-02-09;0;4;0;0;0;0
CL;2020-02-10;1;5;0;1;0;0
CL;2020-02-11;1;6;1;0;0;0
CL;2020-02-12;2;8;2;0;0;0
CL;2020-02-13;3;11;0;3;0;0
CL;2020-02-14;1;12;1;0;0;0
CL;2020-02-15;0;12;0;0;0;0
CL;2020-02-16;0;12;0;0;0;0
CL;2020-02-17;0;12;0;0;0;0
CL;2020-02-18;1;13;1;0;0;0
CL;2020-02-19;1;14;0;1;0;0
CL;2020-02-20;3;17;1;2;0;0
CL;2020-02-21;5;22;3;2;0;0
CL;2020-02-22;2;24;2;0;0;0
CL;2020-02-23;5;29;4;1;0;0
CL;2020-02-24;5;34;4;1;0;0
CL;2020-02-25;6;40;5;1;0;0
CL;2020-02-26;8;48;7;1;0;0
CL;2020-02-27;7;55;6;1;0;0
CL;2020-02-28;11;66;8;3;0;0
CL;2020-02-29;10;76;10;0;0;0
CL;2020-03-01;33;109;29;4;0;0
CL;2020-03-02;44;153;37;7;0;0
CL;2020-03-03;29;182;27;2;0;0
CL;2020-03-04;35;217;31;4;0;0
CL;2020-03-05;55;272;46;9;0;0
CL;2020-03-06;57;329;49;8;0;0
CL;2020-03-07;83;412;71;12;0;0
CL;2020-03-08;80;492;70;10;0;0
CL;2020-03-09;166;658;146;20;0;0
CL;2020-03-10;213;871;191;22;0;0
CL;2020-03-11;255;1126;219;36;0;0
CL;2020-03-12;344;1470;308;36;0;0
CL;2020-03-13;505;1975;446;59;0;0
CL;2020-03-14;521;2496;465;55;1;0
CL;2020-03-15;535;3031;470;65;0;0
CL;2020-03-16;780;3811;679;100;1;0
CL;2020-03-17;730;4541;655;74;1;0
CL;2020-03-18;814;5355;731;83;0;0
CL;2020-03-19;866;6221;799;67;0;0
CL;2020-03-20;953;7174;828;125;0;0
CL;2020-03-21;765;7939;696;69;0;0
CL;2020-03-22;706;8645;630;76;0;0
CL;2020-03-23;770;9415;665;105;0;0
CL;2020-03-24;663;10078;556;106;1;0
CL;2020-03-25;696;10774;599;97;0;0
CL;2020-03-26;555;11329;477;78;0;0
CL;2020-03-27;524;11853;456;68;0;0
CL;2020-03-28;522;12375;460;62;0;0
CL;2020-03-29;423;12798;387;36;0;0
CL;2020-03-30;495;13293;421;74;0;0
CL;2020-03-31;399;13692;359;40;0;0
CL;2020-04-01;561;14253;449;112;0;0
CL;2020-04-02;516;14769;444;72;0;0
CL;2020-04-03;566;15335;490;76;0;0
CL;2020-04-04;569;15904;482;87;0;0
CL;2020-04-05;391;16295;319;72;0;0
CL;2020-04-06;594;16889;461;133;0;0
CL;2020-04-07;429;17318;327;102;0;0
CL;2020-04-08;508;17826;372;136;0;0
CL;2020-04-09;537;18363;351;186;0;0
CL;2020-04-10;558;18921;324;234;0;0
CL;2020-04-11;481;19402;310;171;0;0
CL;2020-04-12;326;19728;159;167;0;0
CL;2020-04-13;511;20239;234;277;0;0
CL;2020-04-14;460;20699;200;260;0;0
CL;2020-04-15;342;21041;174;168;0;0
CL;2020-04-16;297;21338;142;155;0;0
CL;2020-04-17;204;21542;144;60;0;0
CL;2020-04-18;170;21712;94;75;1;0
CL;2020-04-19;218;21930;137;81;0;0
CL;2020-04-20;260;22190;195;64;1;0
CL;2020-04-21;278;22468;119;159;0;0
CL;2020-04-22;256;22724;164;92;0;0
CL;2020-04-23;211;22935;79;132;0;0
CL;2020-04-24;292;23227;138;154;0;0
CL;2020-04-25;139;23366;87;52;0;0
CL;2020-04-26;108;23474;41;67;0;0
CL;2020-04-27;132;23606;44;88;0;0
CL;2020-04-28;323;23929;64;259;0;0
CL;2020-04-29;244;24173;47;197;0;0
CL;2020-04-30;235;24408;67;168;0;0
CL;2020-05-01;336;24744;53;281;2;0
CL;2020-05-02;344;25088;58;286;0;0
CL;2020-05-03;113;25201;58;55;0;0
CL;2020-05-04;92;25293;28;64;0;0
CL;2020-05-05;50;25343;20;30;0;0
CL;2020-05-06;44;25387;29;15;0;0
CL;2020-05-07;70;25457;61;9;0;0
CL;2020-05-08;58;25515;45;13;0;0
CL;2020-05-09;39;25554;34;4;1;0
CL;2020-05-10;32;25586;30;2;0;0
CL;2020-05-11;22;25608;21;1;0;0
CL;2020-05-12;35;25643;31;2;2;0
CL;2020-05-13;38;25681;36;1;1;0
CL;2020-05-14;27;25708;26;0;1;0
CL;2020-05-15;38;25746;36;0;2;0
CL;2020-05-16;45;25791;43;1;1;0
CL;2020-05-17;12;25803;12;0;0;0
CL;2020-05-18;12;25815;12;0;0;0
CL;2020-05-19;34;25849;33;1;0;0
CL;2020-05-20;48;25897;47;0;1;0
CL;2020-05-21;32;25929;31;0;1;0
CL;2020-05-22;45;25974;44;1;0;0
CL;2020-05-23;41;26015;41;0;0;0
CL;2020-05-24;45;26060;45;0;0;0
CL;2020-05-25;29;26089;28;0;1;0
CL;2020-05-26;29;26118;29;0;0;0
CL;2020-05-27;18;26136;18;0;0;0
CL;2020-05-28;29;26165;29;0;0;0
CL;2020-05-29;31;26196;30;0;1;0
CL;2020-05-30;33;26229;33;0;0;0
CL;2020-05-31;13;26242;13;0;0;0
CL;2020-06-01;17;26259;17;0;0;0
CL;2020-06-02;25;26284;25;0;0;0
CL;2020-06-03;26;26310;26;0;0;0
CL;2020-06-04;20;26330;18;0;2;0
CL;2020-06-05;20;26350;20;0;0;0
CL;2020-06-06;22;26372;21;0;1;0
CL;2020-06-07;10;26382;10;0;0;0
CL;2020-06-08;14;26396;14;0;0;0
CL;2020-06-09;13;26409;12;0;1;0
CL;2020-06-10;36;26445;35;0;1;0
CL;2020-06-11;19;26464;19;0;0;0
CL;2020-06-12;13;26477;13;0;0;0
CL;2020-06-13;11;26488;10;0;1;0
CL;2020-06-14;19;26507;17;0;2;0
CL;2020-06-15;11;26518;11;0;0;0
CL;2020-06-16;20;26538;19;0;1;0
CL;2020-06-17;25;26563;24;0;1;0
CL;2020-06-18;15;26578;15;0;0;0
CL;2020-06-19;21;26599;20;0;1;0
CL;2020-06-20;21;26620;20;0;1;0
CL;2020-06-21;15;26635;15;0;0;0
CL;2020-06-22;8;26643;8;0;0;0
CL;2020-06-23;17;26660;17;0;0;0
CL;2020-06-24;12;26672;12;0;0;0
CL;2020-06-25;10;26682;10;0;0;0
CL;2020-06-26;6;26688;6;0;0;0
CL;2020-06-27;12;26700;12;0;0;0
CL;2020-06-28;11;26711;11;0;0;0
CL;2020-06-29;3;26714;3;0;0;0
CL;2020-06-30;2;26716;2;0;0;0
CL;2020-07-01;1;26717;1;0;0;0
CL;2020-07-02;2;26719;2;0;0;0
CL;2020-07-03;0;26719;0;0;0;0
CL;2020-07-04;0;26719;0;0;0;0
CL;2020-07-05;0;26719;0;0;0;0
CM;2020-01-31;0;0;0;0;0;0
CM;2020-02-01;0;0;0;0;0;0
CM;2020-02-02;0;0;0;0;0;0
CM;2020-02-03;0;0;0;0;0;0
CM;2020-02-04;0;0;0;0;0;0
CM;2020-02-05;0;0;0;0;0;0
CM;2020-02-06;0;0;0;0;0;0
CM;2020-02-07;0;0;0;0;0;0
CM;2020-02-08;0;0;0;0;0;0
CM;2020-02-09;0;0;0;0;0;0
CM;2020-02-10;0;0;0;0;0;0
CM;2020-02-11;0;0;0;0;0;0
CM;2020-02-12;0;0;0;0;0;0
CM;2020-02-13;0;0;0;0;0;0
CM;2020-02-14;0;0;0;0;0;0
CM;2020-02-15;0;0;0;0;0;0
CM;2020-02-16;0;0;0;0;0;0
CM;2020-02-17;0;0;0;0;0;0
CM;2020-02-18;0;0;0;0;0;0
CM;2020-02-19;0;0;0;0;0;0
CM;2020-02-20;2;2;1;0;0;1
CM;2020-02-21;0;2;0;0;0;0
CM;2020-02-22;0;2;0;0;0;0
CM;2020-02-23;0;2;0;0;0;0
CM;2020-02-24;5;7;1;0;0;4
CM;2020-02-25;5;12;1;0;0;4
CM;2020-02-26;6;18;3;0;0;3
CM;2020-02-27;9;27;2;0;0;7
CM;2020-02-28;13;40;4;1;0;8
CM;2020-02-29;15;55;3;0;0;12
CM;2020-03-01;64;119;14;0;2;48
CM;2020-03-02;62;181;18;0;5;39
CM;2020-03-03;49;230;15;0;0;34
CM;2020-03-04;62;292;17;1;2;42
CM;2020-03-05;79;371;20;1;2;56
CM;2020-03-06;105;476;27;0;0;78
CM;2020-03-07;144;620;33;1;1;109
CM;2020-03-08;163;783;28;0;0;135
CM;2020-03-09;215;998;45;0;0;170
CM;2020-03-10;301;1299;84;1;0;216
CM;2020-03-11;330;1629;80;2;1;247
CM;2020-03-12;462;2091;112;4;3;343
CM;2020-03-13;633;2724;183;1;3;446
CM;2020-03-14;618;3342;161;1;2;454
CM;2020-03-15;786;4128;251;3;6;526
CM;2020-03-16;816;4944;240;3;1;572
CM;2020-03-17;747;5691;198;5;2;542
CM;2020-03-18;807;6498;220;4;1;582
CM;2020-03-19;757;7255;245;3;2;507
CM;2020-03-20;947;8202;315;9;6;617
CM;2020-03-21;631;8833;203;6;1;421
CM;2020-03-22;681;9514;184;13;0;484
CM;2020-03-23;766;10280;253;13;1;499
CM;2020-03-24;659;10939;253;18;1;387
CM;2020-03-25;672;11611;246;20;3;403
CM;2020-03-26;593;12204;243;16;2;332
CM;2020-03-27;514;12718;199;14;5;296
CM;2020-03-28;422;13140;176;25;1;220
CM;2020-03-29;379;13519;174;21;0;184
CM;2020-03-30;528;14047;231;23;3;271
CM;2020-03-31;415;14462;171;30;2;212
CM;2020-04-01;469;14931;198;35;1;235
CM;2020-04-02;367;15298;148;24;1;194
CM;2020-04-03;340;15638;147;27;1;165
CM;2020-04-04;385;16023;146;35;0;204
CM;2020-04-05;464;16487;238;33;1;192
CM;2020-04-06;420;16907;128;25;1;266
CM;2020-04-07;365;17272;97;23;0;245
CM;2020-04-08;366;17638;107;21;0;238
CM;2020-04-09;350;17988;82;9;2;257
CM;2020-04-10;300;18288;70;18;0;212
CM;2020-04-11;158;18446;62;13;0;83
CM;2020-04-12;229;18675;75;6;0;148
CM;2020-04-13;329;19004;106;10;1;212
CM;2020-04-14;238;19242;68;17;0;153
CM;2020-04-15;180;19422;77;6;0;97
CM;2020-04-16;129;19551;35;10;0;84
CM;2020-04-17;147;19698;25;14;0;108
CM;2020-04-18;98;19796;33;6;0;59
CM;2020-04-19;110;19906;37;1;0;72
CM;2020-04-20;144;20050;54;3;0;87
CM;2020-04-21;147;20197;34;4;0;109
CM;2020-04-22;150;20347;23;5;0;122
CM;2020-04-23;88;20435;21;2;0;65
CM;2020-04-24;56;20491;15;0;1;40
CM;2020-04-25;49;20540;11;2;0;36
CM;2020-04-26;95;20635;17;4;0;74
CM;2020-04-27;104;20739;24;1;0;79
CM;2020-04-28;93;20832;18;1;0;74
CM;2020-04-29;71;20903;10;2;2;57
CM;2020-04-30;75;20978;9;0;0;66
CM;2020-05-01;20;20998;8;3;0;9
CM;2020-05-02;17;21015;7;4;0;6
CM;2020-05-03;48;21063;6;2;0;40
CM;2020-05-04;21;21084;15;1;3;2
CM;2020-05-05;25;21109;21;0;4;0
CM;2020-05-06;29;21138;27;0;2;0
CM;2020-05-07;36;21174;33;0;3;0
CM;2020-05-08;29;21203;27;0;2;0
CM;2020-05-09;35;21238;33;0;2;0
CM;2020-05-10;21;21259;17;1;3;0
CM;2020-05-11;22;21281;18;0;4;0
CM;2020-05-12;25;21306;20;0;5;0
CM;2020-05-13;43;21349;36;0;7;0
CM;2020-05-14;29;21378;29;0;0;0
CM;2020-05-15;25;21403;23;0;2;0
CM;2020-05-16;47;21450;43;0;4;0
CM;2020-05-17;22;21472;18;0;4;0
CM;2020-05-18;28;21500;25;0;3;0
CM;2020-05-19;25;21525;24;0;1;0
CM;2020-05-20;33;21558;29;0;4;0
CM;2020-05-21;33;21591;31;0;2;0
CM;2020-05-22;45;21636;41;0;4;0
CM;2020-05-23;31;21667;30;0;1;0
CM;2020-05-24;42;21709;36;0;6;0
CM;2020-05-25;30;21739;29;0;1;0
CM;2020-05-26;31;21770;30;0;1;0
CM;2020-05-27;38;21808;28;0;10;0
CM;2020-05-28;43;21851;41;0;2;0
CM;2020-05-29;39;21890;32;0;7;0
CM;2020-05-30;32;21922;31;0;1;0
CM;2020-05-31;14;21936;12;0;2;0
CM;2020-06-01;24;21960;23;0;1;0
CM;2020-06-02;28;21988;27;0;1;0
CM;2020-06-03;25;22013;25;0;0;0
CM;2020-06-04;24;22037;22;0;2;0
CM;2020-06-05;17;22054;16;0;1;0
CM;2020-06-06;20;22074;18;0;2;0
CM;2020-06-07;13;22087;11;0;2;0
CM;2020-06-08;14;22101;14;0;0;0
CM;2020-06-09;9;22110;9;0;0;0
CM;2020-06-10;22;22132;22;0;0;0
CM;2020-06-11;10;22142;10;0;0;0
CM;2020-06-12;14;22156;14;0;0;0
CM;2020-06-13;13;22169;13;0;0;0
CM;2020-06-14;23;22192;23;0;0;0
CM;2020-06-15;22;22214;22;0;0;0
CM;2020-06-16;8;22222;7;0;1;0
CM;2020-06-17;8;22230;8;0;0;0
CM;2020-06-18;15;22245;15;0;0;0
CM;2020-06-19;16;22261;16;0;0;0
CM;2020-06-20;24;22285;24;0;0;0
CM;2020-06-21;20;22305;20;0;0;0
CM;2020-06-22;13;22318;13;0;0;0
CM;2020-06-23;16;22334;16;0;0;0
CM;2020-06-24;12;22346;12;0;0;0
CM;2020-06-25;16;22362;16;0;0;0
CM;2020-06-26;15;22377;15;0;0;0
CM;2020-06-27;11;22388;11;0;0;0
CM;2020-06-28;18;22406;18;0;0;0
CM;2020-06-29;10;22416;10;0;0;0
CM;2020-06-30;8;22424;8;0;0;0
CM;2020-07-01;7;22431;7;0;0;0
CM;2020-07-02;2;22433;2;0;0;0
CM;2020-07-03;1;22434;1;0;0;0
CM;2020-07-04;1;22435;1;0;0;0
CM;2020-07-05;0;22435;0;0;0;0
CN;2020-01-31;0;0;0;0;0;0
CN;2020-02-01;0;0;0;0;0;0
CN;2020-02-02;1;1;0;0;0;1
CN;2020-02-03;0;1;0;0;0;0
CN;2020-02-04;1;2;1;0;0;0
CN;2020-02-05;0;2;0;0;0;0
CN;2020-02-06;0;2;0;0;0;0
CN;2020-02-07;0;2;0;0;0;0
CN;2020-02-08;0;2;0;0;0;0
CN;2020-02-09;0;2;0;0;0;0
CN;2020-02-10;0;2;0;0;0;0
CN;2020-02-11;0;2;0;0;0;0
CN;2020-02-12;1;3;1;0;0;0
CN;2020-02-13;0;3;0;0;0;0
CN;2020-02-14;1;4;1;0;0;0
CN;2020-02-15;0;4;0;0;0;0
CN;2020-02-16;2;6;2;0;0;0
CN;2020-02-17;0;6;0;0;0;0
CN;2020-02-18;1;7;1;0;0;0
CN;2020-02-19;1;8;1;0;0;0
CN;2020-02-20;1;9;1;0;0;0
CN;2020-02-21;0;9;0;0;0;0
CN;2020-02-22;0;9;0;0;0;0
CN;2020-02-23;2;11;2;0;0;0
CN;2020-02-24;0;11;0;0;0;0
CN;2020-02-25;2;13;1;0;0;1
CN;2020-02-26;7;20;7;0;0;0
CN;2020-02-27;1;21;1;0;0;0
CN;2020-02-28;8;29;7;0;0;1
CN;2020-02-29;6;35;6;0;0;0
CN;2020-03-01;7;42;7;0;0;0
CN;2020-03-02;12;54;12;0;0;0
CN;2020-03-03;8;62;8;0;0;0
CN;2020-03-04;14;76;14;0;0;0
CN;2020-03-05;16;92;15;0;0;1
CN;2020-03-06;25;117;24;0;0;1
CN;2020-03-07;19;136;18;0;0;1
CN;2020-03-08;35;171;31;0;0;4
CN;2020-03-09;47;218;40;0;0;7
CN;2020-03-10;56;274;51;0;0;5
CN;2020-03-11;60;334;54;0;0;6
CN;2020-03-12;73;407;69;0;0;4
CN;2020-03-13;109;516;100;0;0;9
CN;2020-03-14;97;613;93;0;0;4
CN;2020-03-15;91;704;89;0;0;2
CN;2020-03-16;132;836;116;0;0;16
CN;2020-03-17;93;929;90;0;0;3
CN;2020-03-18;117;1046;109;0;0;8
CN;2020-03-19;78;1124;70;0;0;8
CN;2020-03-20;117;1241;111;0;0;6
CN;2020-03-21;86;1327;77;0;0;9
CN;2020-03-22;75;1402;73;0;0;2
CN;2020-03-23;97;1499;91;0;0;6
CN;2020-03-24;63;1562;59;0;0;4
CN;2020-03-25;55;1617;54;0;0;1
CN;2020-03-26;62;1679;60;0;0;2
CN;2020-03-27;71;1750;69;0;0;2
CN;2020-03-28;36;1786;35;0;0;1
CN;2020-03-29;42;1828;42;0;0;0
CN;2020-03-30;51;1879;49;0;0;2
CN;2020-03-31;28;1907;27;0;0;1
CN;2020-04-01;51;1958;50;0;0;1
CN;2020-04-02;34;1992;32;0;0;2
CN;2020-04-03;17;2009;17;0;0;0
CN;2020-04-04;29;2038;28;0;0;1
CN;2020-04-05;17;2055;15;0;0;2
CN;2020-04-06;13;2068;13;0;0;0
CN;2020-04-07;26;2094;24;0;0;2
CN;2020-04-08;16;2110;14;0;0;2
CN;2020-04-09;26;2136;23;0;0;3
CN;2020-04-10;14;2150;13;0;0;1
CN;2020-04-11;14;2164;14;0;0;0
CN;2020-04-12;8;2172;8;0;0;0
CN;2020-04-13;13;2185;12;0;0;1
CN;2020-04-14;13;2198;12;0;0;1
CN;2020-04-15;15;2213;15;0;0;0
CN;2020-04-16;15;2228;14;0;0;1
CN;2020-04-17;8;2236;8;0;0;0
CN;2020-04-18;9;2245;9;0;0;0
CN;2020-04-19;15;2260;15;0;0;0
CN;2020-04-20;16;2276;15;0;0;1
CN;2020-04-21;7;2283;7;0;0;0
CN;2020-04-22;7;2290;7;0;0;0
CN;2020-04-23;5;2295;3;0;0;2
CN;2020-04-24;11;2306;10;0;0;1
CN;2020-04-25;4;2310;4;0;0;0
CN;2020-04-26;2;2312;2;0;0;0
CN;2020-04-27;3;2315;3;0;0;0
CN;2020-04-28;4;2319;1;0;0;3
CN;2020-04-29;4;2323;3;0;0;1
CN;2020-04-30;4;2327;4;0;0;0
CN;2020-05-01;9;2336;9;0;0;0
CN;2020-05-02;5;2341;5;0;0;0
CN;2020-05-03;0;2341;0;0;0;0
CN;2020-05-04;3;2344;3;0;0;0
CN;2020-05-05;4;2348;4;0;0;0
CN;2020-05-06;1;2349;1;0;0;0
CN;2020-05-07;5;2354;5;0;0;0
CN;2020-05-08;2;2356;2;0;0;0
CN;2020-05-09;4;2360;4;0;0;0
CN;2020-05-10;5;2365;5;0;0;0
CN;2020-05-11;0;2365;0;0;0;0
CN;2020-05-12;3;2368;3;0;0;0
CN;2020-05-13;10;2378;10;0;0;0
CN;2020-05-14;3;2381;3;0;0;0
CN;2020-05-15;5;2386;5;0;0;0
CN;2020-05-16;4;2390;4;0;0;0
CN;2020-05-17;2;2392;2;0;0;0
CN;2020-05-18;3;2395;3;0;0;0
CN;2020-05-19;5;2400;5;0;0;0
CN;2020-05-20;3;2403;3;0;0;0
CN;2020-05-21;1;2404;1;0;0;0
CN;2020-05-22;6;2410;6;0;0;0
CN;2020-05-23;8;2418;8;0;0;0
CN;2020-05-24;3;2421;3;0;0;0
CN;2020-05-25;1;2422;1;0;0;0
CN;2020-05-26;4;2426;4;0;0;0
CN;2020-05-27;6;2432;6;0;0;0
CN;2020-05-28;5;2437;5;0;0;0
CN;2020-05-29;1;2438;1;0;0;0
CN;2020-05-30;1;2439;1;0;0;0
CN;2020-05-31;4;2443;4;0;0;0
CN;2020-06-01;2;2445;2;0;0;0
CN;2020-06-02;2;2447;2;0;0;0
CN;2020-06-03;0;2447;0;0;0;0
CN;2020-06-04;2;2449;2;0;0;0
CN;2020-06-05;2;2451;2;0;0;0
CN;2020-06-06;2;2453;2;0;0;0
CN;2020-06-07;1;2454;1;0;0;0
CN;2020-06-08;1;2455;1;0;0;0
CN;2020-06-09;3;2458;3;0;0;0
CN;2020-06-10;2;2460;2;0;0;0
CN;2020-06-11;15;2475;14;0;0;1
CN;2020-06-12;1;2476;1;0;0;0
CN;2020-06-13;2;2478;2;0;0;0
CN;2020-06-14;12;2490;12;0;0;0
CN;2020-06-15;0;2490;0;0;0;0
CN;2020-06-16;0;2490;0;0;0;0
CN;2020-06-17;6;2496;6;0;0;0
CN;2020-06-18;1;2497;1;0;0;0
CN;2020-06-19;1;2498;1;0;0;0
CN;2020-06-20;0;2498;0;0;0;0
CN;2020-06-21;1;2499;1;0;0;0
CN;2020-06-22;0;2499;0;0;0;0
CN;2020-06-23;0;2499;0;0;0;0
CN;2020-06-24;4;2503;4;0;0;0
CN;2020-06-25;4;2507;4;0;0;0
CN;2020-06-26;1;2508;1;0;0;0
CN;2020-06-27;3;2511;3;0;0;0
CN;2020-06-28;1;2512;1;0;0;0
CN;2020-06-29;0;2512;0;0;0;0
CN;2020-06-30;1;2513;1;0;0;0
CN;2020-07-01;0;2513;0;0;0;0
CN;2020-07-02;1;2514;1;0;0;0
CN;2020-07-03;0;2514;0;0;0;0
CN;2020-07-04;0;2514;0;0;0;0
CN;2020-07-05;0;2514;0;0;0;0
CT;2020-01-31;0;0;0;0;0;0
CT;2020-02-01;7;7;5;0;0;2
CT;2020-02-02;1;8;0;0;0;1
CT;2020-02-03;2;10;1;0;0;1
CT;2020-02-04;4;14;4;0;0;0
CT;2020-02-05;2;16;2;0;0;0
CT;2020-02-06;1;17;1;0;0;0
CT;2020-02-07;2;19;1;0;0;1
CT;2020-02-08;0;19;0;0;0;0
CT;2020-02-09;1;20;0;0;0;1
CT;2020-02-10;3;23;3;0;0;0
CT;2020-02-11;2;25;1;0;0;1
CT;2020-02-12;5;30;4;0;0;1
CT;2020-02-13;9;39;7;0;0;2
CT;2020-02-14;1;40;1;0;0;0
CT;2020-02-15;8;48;8;0;0;0
CT;2020-02-16;5;53;4;0;0;1
CT;2020-02-17;2;55;1;0;0;1
CT;2020-02-18;4;59;4;0;0;0
CT;2020-02-19;1;60;1;0;0;0
CT;2020-02-20;11;71;8;0;0;3
CT;2020-02-21;14;85;12;0;0;2
CT;2020-02-22;11;96;9;0;0;2
CT;2020-02-23;8;104;6;0;0;2
CT;2020-02-24;14;118;9;0;0;5
CT;2020-02-25;21;139;17;0;1;3
CT;2020-02-26;31;170;20;0;0;11
CT;2020-02-27;15;185;12;0;0;3
CT;2020-02-28;35;220;28;0;1;6
CT;2020-02-29;27;247;19;0;0;8
CT;2020-03-01;86;333;75;0;1;10
CT;2020-03-02;81;414;60;0;1;20
CT;2020-03-03;89;503;74;0;1;14
CT;2020-03-04;148;651;127;0;2;19
CT;2020-03-05;174;825;155;0;1;18
CT;2020-03-06;270;1095;238;0;3;29
CT;2020-03-07;293;1388;260;0;3;30
CT;2020-03-08;332;1720;304;0;1;27
CT;2020-03-09;567;2287;514;0;2;51
CT;2020-03-10;797;3084;722;0;1;74
CT;2020-03-11;758;3842;701;0;2;55
CT;2020-03-12;1029;4871;968;0;1;60
CT;2020-03-13;1363;6234;1266;0;6;91
CT;2020-03-14;1324;7558;1236;0;6;82
CT;2020-03-15;1369;8927;1288;0;11;70
CT;2020-03-16;1710;10637;1543;0;9;158
CT;2020-03-17;1565;12202;1475;0;8;82
CT;2020-03-18;1685;13887;1582;0;6;97
CT;2020-03-19;1609;15496;1522;0;5;82
CT;2020-03-20;1896;17392;1790;0;7;99
CT;2020-03-21;1461;18853;1389;0;8;64
CT;2020-03-22;1308;20161;1234;0;0;74
CT;2020-03-23;1508;21669;1405;0;11;92
CT;2020-03-24;1413;23082;1334;0;1;78
CT;2020-03-25;1324;24406;1251;0;3;70
CT;2020-03-26;1390;25796;1323;0;1;66
CT;2020-03-27;1251;27047;1193;0;4;54
CT;2020-03-28;1327;28374;1260;0;5;62
CT;2020-03-29;1041;29415;971;0;5;65
CT;2020-03-30;1204;30619;1107;0;8;89
CT;2020-03-31;1131;31750;1071;0;1;59
CT;2020-04-01;1280;33030;1211;0;7;62
CT;2020-04-02;1066;34096;1010;0;1;55
CT;2020-04-03;1210;35306;1167;1;3;39
CT;2020-04-04;967;36273;926;0;2;39
CT;2020-04-05;845;37118;805;0;0;40
CT;2020-04-06;818;37936;739;0;1;78
CT;2020-04-07;744;38680;678;0;0;66
CT;2020-04-08;993;39673;951;0;2;40
CT;2020-04-09;1048;40721;1005;0;1;42
CT;2020-04-10;1008;41729;963;0;0;45
CT;2020-04-11;1060;42789;1030;0;1;29
CT;2020-04-12;667;43456;645;0;1;21
CT;2020-04-13;596;44052;548;0;2;46
CT;2020-04-14;720;44772;691;0;1;28
CT;2020-04-15;745;45517;721;0;1;23
CT;2020-04-16;711;46228;697;0;0;14
CT;2020-04-17;607;46835;580;0;0;27
CT;2020-04-18;451;47286;427;0;0;24
CT;2020-04-19;265;47551;255;0;0;10
CT;2020-04-20;365;47916;338;0;1;26
CT;2020-04-21;199;48115;179;0;1;19
CT;2020-04-22;325;48440;303;0;1;21
CT;2020-04-23;274;48714;259;0;0;15
CT;2020-04-24;272;48986;246;0;1;25
CT;2020-04-25;173;49159;162;0;1;10
CT;2020-04-26;138;49297;132;0;0;6
CT;2020-04-27;142;49439;122;0;0;20
CT;2020-04-28;158;49597;151;0;0;7
CT;2020-04-29;150;49747;138;0;0;12
CT;2020-04-30;188;49935;175;0;1;12
CT;2020-05-01;162;50097;151;0;1;10
CT;2020-05-02;154;50251;149;0;0;5
CT;2020-05-03;136;50387;127;0;0;9
CT;2020-05-04;114;50501;107;0;1;6
CT;2020-05-05;95;50596;58;0;30;7
CT;2020-05-06;93;50689;58;0;27;8
CT;2020-05-07;148;50837;115;0;30;3
CT;2020-05-08;173;51010;122;0;47;4
CT;2020-05-09;176;51186;133;0;38;5
CT;2020-05-10;117;51303;114;0;0;3
CT;2020-05-11;75;51378;74;0;1;0
CT;2020-05-12;184;51562;146;0;37;1
CT;2020-05-13;196;51758;150;0;46;0
CT;2020-05-14;193;51951;141;0;52;0
CT;2020-05-15;244;52195;178;0;66;0
CT;2020-05-16;305;52500;235;0;70;0
CT;2020-05-17;120;52620;118;0;2;0
CT;2020-05-18;160;52780;159;0;0;1
CT;2020-05-19;189;52969;128;0;61;0
CT;2020-05-20;204;53173;147;0;55;2
CT;2020-05-21;145;53318;103;0;42;0
CT;2020-05-22;182;53500;118;0;63;1
CT;2020-05-23;174;53674;130;0;44;0
CT;2020-05-24;105;53779;101;0;3;1
CT;2020-05-25;100;53879;99;0;1;0
CT;2020-05-26;56;53935;52;0;4;0
CT;2020-05-27;93;54028;75;0;18;0
CT;2020-05-28;122;54150;96;0;26;0
CT;2020-05-29;114;54264;81;0;32;1
CT;2020-05-30;176;54440;152;0;24;0
CT;2020-05-31;62;54502;62;0;0;0
CT;2020-06-01;81;54583;80;0;1;0
CT;2020-06-02;102;54685;90;0;12;0
CT;2020-06-03;110;54795;79;0;31;0
CT;2020-06-04;132;54927;84;0;48;0
CT;2020-06-05;97;55024;55;0;42;0
CT;2020-06-06;102;55126;75;0;27;0
CT;2020-06-07;40;55166;35;0;4;1
CT;2020-06-08;61;55227;60;0;1;0
CT;2020-06-09;62;55289;40;0;22;0
CT;2020-06-10;65;55354;52;0;13;0
CT;2020-06-11;73;55427;56;0;17;0
CT;2020-06-12;74;55501;60;0;14;0
CT;2020-06-13;65;55566;51;0;14;0
CT;2020-06-14;42;55608;41;0;1;0
CT;2020-06-15;43;55651;42;0;1;0
CT;2020-06-16;68;55719;50;0;18;0
CT;2020-06-17;113;55832;91;0;22;0
CT;2020-06-18;62;55894;62;0;0;0
CT;2020-06-19;99;55993;64;0;35;0
CT;2020-06-20;156;56149;117;0;39;0
CT;2020-06-21;65;56214;65;0;0;0
CT;2020-06-22;89;56303;88;0;1;0
CT;2020-06-23;98;56401;80;0;17;1
CT;2020-06-24;141;56542;127;0;14;0
CT;2020-06-25;175;56717;153;0;22;0
CT;2020-06-26;209;56926;188;0;21;0
CT;2020-06-27;275;57201;268;0;7;0
CT;2020-06-28;191;57392;191;0;0;0
CT;2020-06-29;171;57563;171;0;0;0
CT;2020-06-30;98;57661;96;0;0;2
CT;2020-07-01;59;57720;59;0;0;0
CT;2020-07-02;36;57756;36;0;0;0
CT;2020-07-03;2;57758;2;0;0;0
CT;2020-07-04;4;57762;4;0;0;0
CT;2020-07-05;0;57762;0;0;0;0
EX;2020-01-31;0;0;0;0;0;0
EX;2020-02-01;0;0;0;0;0;0
EX;2020-02-02;2;2;0;2;0;0
EX;2020-02-03;0;2;0;0;0;0
EX;2020-02-04;0;2;0;0;0;0
EX;2020-02-05;0;2;0;0;0;0
EX;2020-02-06;0;2;0;0;0;0
EX;2020-02-07;0;2;0;0;0;0
EX;2020-02-08;1;3;1;0;0;0
EX;2020-02-09;0;3;0;0;0;0
EX;2020-02-10;0;3;0;0;0;0
EX;2020-02-11;0;3;0;0;0;0
EX;2020-02-12;0;3;0;0;0;0
EX;2020-02-13;1;4;0;1;0;0
EX;2020-02-14;1;5;1;0;0;0
EX;2020-02-15;2;7;1;1;0;0
EX;2020-02-16;0;7;0;0;0;0
EX;2020-02-17;1;8;0;1;0;0
EX;2020-02-18;0;8;0;0;0;0
EX;2020-02-19;1;9;1;0;0;0
EX;2020-02-20;1;10;0;1;0;0
EX;2020-02-21;1;11;0;1;0;0
EX;2020-02-22;0;11;0;0;0;0
EX;2020-02-23;0;11;0;0;0;0
EX;2020-02-24;0;11;0;0;0;0
EX;2020-02-25;5;16;2;3;0;0
EX;2020-02-26;1;17;0;1;0;0
EX;2020-02-27;3;20;1;2;0;0
EX;2020-02-28;7;27;4;3;0;0
EX;2020-02-29;5;32;3;2;0;0
EX;2020-03-01;5;37;3;2;0;0
EX;2020-03-02;7;44;6;1;0;0
EX;2020-03-03;9;53;4;5;0;0
EX;2020-03-04;9;62;6;3;0;0
EX;2020-03-05;6;68;5;1;0;0
EX;2020-03-06;20;88;11;9;0;0
EX;2020-03-07;16;104;13;3;0;0
EX;2020-03-08;19;123;12;7;0;0
EX;2020-03-09;38;161;31;7;0;0
EX;2020-03-10;47;208;38;9;0;0
EX;2020-03-11;74;282;57;17;0;0
EX;2020-03-12;88;370;73;15;0;0
EX;2020-03-13;95;465;82;13;0;0
EX;2020-03-14;91;556;73;18;0;0
EX;2020-03-15;86;642;62;24;0;0
EX;2020-03-16;118;760;95;23;0;0
EX;2020-03-17;109;869;97;12;0;0
EX;2020-03-18;127;996;106;21;0;0
EX;2020-03-19;127;1123;104;23;0;0
EX;2020-03-20;173;1296;140;33;0;0
EX;2020-03-21;133;1429;113;20;0;0
EX;2020-03-22;131;1560;116;15;0;0
EX;2020-03-23;245;1805;209;36;0;0
EX;2020-03-24;161;1966;138;23;0;0
EX;2020-03-25;153;2119;121;32;0;0
EX;2020-03-26;138;2257;120;18;0;0
EX;2020-03-27;109;2366;91;18;0;0
EX;2020-03-28;96;2462;72;24;0;0
EX;2020-03-29;62;2524;51;11;0;0
EX;2020-03-30;107;2631;66;41;0;0
EX;2020-03-31;61;2692;37;24;0;0
EX;2020-04-01;134;2826;89;45;0;0
EX;2020-04-02;76;2902;51;25;0;0
EX;2020-04-03;104;3006;65;39;0;0
EX;2020-04-04;75;3081;47;28;0;0
EX;2020-04-05;53;3134;25;28;0;0
EX;2020-04-06;78;3212;37;41;0;0
EX;2020-04-07;72;3284;27;45;0;0
EX;2020-04-08;83;3367;36;47;0;0
EX;2020-04-09;76;3443;21;55;0;0
EX;2020-04-10;98;3541;39;59;0;0
EX;2020-04-11;72;3613;27;45;0;0
EX;2020-04-12;47;3660;21;26;0;0
EX;2020-04-13;68;3728;24;44;0;0
EX;2020-04-14;87;3815;28;59;0;0
EX;2020-04-15;97;3912;25;72;0;0
EX;2020-04-16;69;3981;23;45;1;0
EX;2020-04-17;101;4082;28;73;0;0
EX;2020-04-18;91;4173;18;73;0;0
EX;2020-04-19;48;4221;11;36;1;0
EX;2020-04-20;49;4270;31;18;0;0
EX;2020-04-21;69;4339;16;53;0;0
EX;2020-04-22;84;4423;26;58;0;0
EX;2020-04-23;84;4507;14;70;0;0
EX;2020-04-24;112;4619;16;96;0;0
EX;2020-04-25;87;4706;23;64;0;0
EX;2020-04-26;24;4730;12;12;0;0
EX;2020-04-27;20;4750;10;10;0;0
EX;2020-04-28;26;4776;5;21;0;0
EX;2020-04-29;59;4835;15;44;0;0
EX;2020-04-30;86;4921;13;73;0;0
EX;2020-05-01;97;5018;23;74;0;0
EX;2020-05-02;58;5076;13;45;0;0
EX;2020-05-03;11;5087;5;6;0;0
EX;2020-05-04;20;5107;12;8;0;0
EX;2020-05-05;41;5148;1;40;0;0
EX;2020-05-06;41;5189;10;31;0;0
EX;2020-05-07;57;5246;8;49;0;0
EX;2020-05-08;34;5280;4;29;1;0
EX;2020-05-09;53;5333;3;50;0;0
EX;2020-05-10;6;5339;4;2;0;0
EX;2020-05-11;10;5349;6;4;0;0
EX;2020-05-12;35;5384;4;30;1;0
EX;2020-05-13;34;5418;2;31;1;0
EX;2020-05-14;23;5441;1;22;0;0
EX;2020-05-15;25;5466;3;22;0;0
EX;2020-05-16;23;5489;3;20;0;0
EX;2020-05-17;4;5493;1;3;0;0
EX;2020-05-18;2;5495;1;1;0;0
EX;2020-05-19;11;5506;2;9;0;0
EX;2020-05-20;13;5519;2;11;0;0
EX;2020-05-21;8;5527;1;7;0;0
EX;2020-05-22;8;5535;0;7;1;0
EX;2020-05-23;8;5543;1;7;0;0
EX;2020-05-24;7;5550;3;4;0;0
EX;2020-05-25;3;5553;3;0;0;0
EX;2020-05-26;14;5567;3;11;0;0
EX;2020-05-27;8;5575;2;6;0;0
EX;2020-05-28;0;5575;0;0;0;0
EX;2020-05-29;8;5583;3;5;0;0
EX;2020-05-30;6;5589;0;6;0;0
EX;2020-05-31;2;5591;1;1;0;0
EX;2020-06-01;3;5594;2;1;0;0
EX;2020-06-02;10;5604;4;5;1;0
EX;2020-06-03;8;5612;2;6;0;0
EX;2020-06-04;4;5616;3;1;0;0
EX;2020-06-05;0;5616;0;0;0;0
EX;2020-06-06;1;5617;1;0;0;0
EX;2020-06-07;5;5622;2;3;0;0
EX;2020-06-08;0;5622;0;0;0;0
EX;2020-06-09;2;5624;2;0;0;0
EX;2020-06-10;1;5625;1;0;0;0
EX;2020-06-11;6;5631;6;0;0;0
EX;2020-06-12;1;5632;1;0;0;0
EX;2020-06-13;1;5633;1;0;0;0
EX;2020-06-14;1;5634;1;0;0;0
EX;2020-06-15;7;5641;7;0;0;0
EX;2020-06-16;1;5642;1;0;0;0
EX;2020-06-17;6;5648;6;0;0;0
EX;2020-06-18;4;5652;4;0;0;0
EX;2020-06-19;4;5656;4;0;0;0
EX;2020-06-20;0;5656;0;0;0;0
EX;2020-06-21;1;5657;1;0;0;0
EX;2020-06-22;1;5658;1;0;0;0
EX;2020-06-23;3;5661;2;1;0;0
EX;2020-06-24;5;5666;5;0;0;0
EX;2020-06-25;7;5673;7;0;0;0
EX;2020-06-26;3;5676;3;0;0;0
EX;2020-06-27;9;5685;9;0;0;0
EX;2020-06-28;5;5690;5;0;0;0
EX;2020-06-29;2;5692;2;0;0;0
EX;2020-06-30;4;5696;4;0;0;0
EX;2020-07-01;3;5699;3;0;0;0
EX;2020-07-02;0;5699;0;0;0;0
EX;2020-07-03;1;5700;1;0;0;0
EX;2020-07-04;1;5701;1;0;0;0
EX;2020-07-05;0;0;0;0;0;0
GA;2020-01-31;0;0;0;0;0;0
GA;2020-02-01;0;0;0;0;0;0
GA;2020-02-02;1;1;1;0;0;0
GA;2020-02-03;1;2;1;0;0;0
GA;2020-02-04;1;3;0;1;0;0
GA;2020-02-05;1;4;0;0;0;1
GA;2020-02-06;0;4;0;0;0;0
GA;2020-02-07;0;4;0;0;0;0
GA;2020-02-08;0;4;0;0;0;0
GA;2020-02-09;0;4;0;0;0;0
GA;2020-02-10;0;4;0;0;0;0
GA;2020-02-11;0;4;0;0;0;0
GA;2020-02-12;0;4;0;0;0;0
GA;2020-02-13;0;4;0;0;0;0
GA;2020-02-14;0;4;0;0;0;0
GA;2020-02-15;0;4;0;0;0;0
GA;2020-02-16;1;5;1;0;0;0
GA;2020-02-17;0;5;0;0;0;0
GA;2020-02-18;1;6;1;0;0;0
GA;2020-02-19;1;7;0;0;0;1
GA;2020-02-20;3;10;3;0;0;0
GA;2020-02-21;0;10;0;0;0;0
GA;2020-02-22;3;13;2;1;0;0
GA;2020-02-23;0;13;0;0;0;0
GA;2020-02-24;1;14;1;0;0;0
GA;2020-02-25;3;17;2;0;0;1
GA;2020-02-26;3;20;3;0;0;0
GA;2020-02-27;7;27;7;0;0;0
GA;2020-02-28;6;33;6;0;0;0
GA;2020-02-29;1;34;1;0;0;0
GA;2020-03-01;6;40;4;2;0;0
GA;2020-03-02;19;59;19;0;0;0
GA;2020-03-03;16;75;16;0;0;0
GA;2020-03-04;14;89;13;0;0;1
GA;2020-03-05;19;108;18;0;0;1
GA;2020-03-06;26;134;26;0;0;0
GA;2020-03-07;33;167;32;0;0;1
GA;2020-03-08;38;205;35;0;0;3
GA;2020-03-09;83;288;81;1;0;1
GA;2020-03-10;119;407;114;2;0;3
GA;2020-03-11;132;539;130;1;0;1
GA;2020-03-12;181;720;181;0;0;0
GA;2020-03-13;243;963;242;0;0;1
GA;2020-03-14;240;1203;238;1;0;1
GA;2020-03-15;270;1473;269;1;0;0
GA;2020-03-16;389;1862;383;3;0;3
GA;2020-03-17;328;2190;324;3;0;1
GA;2020-03-18;309;2499;306;1;0;2
GA;2020-03-19;294;2793;290;4;0;0
GA;2020-03-20;471;3264;463;4;0;4
GA;2020-03-21;277;3541;273;1;0;3
GA;2020-03-22;250;3791;249;1;0;0
GA;2020-03-23;385;4176;379;4;0;2
GA;2020-03-24;295;4471;291;1;0;3
GA;2020-03-25;288;4759;283;4;0;1
GA;2020-03-26;300;5059;295;4;0;1
GA;2020-03-27;306;5365;301;3;0;2
GA;2020-03-28;336;5701;333;1;0;2
GA;2020-03-29;198;5899;196;1;0;1
GA;2020-03-30;282;6181;273;5;0;4
GA;2020-03-31;167;6348;161;4;0;2
GA;2020-04-01;240;6588;233;4;0;3
GA;2020-04-02;266;6854;259;4;0;3
GA;2020-04-03;209;7063;209;0;0;0
GA;2020-04-04;134;7197;133;0;0;1
GA;2020-04-05;118;7315;115;2;0;1
GA;2020-04-06;184;7499;177;6;0;1
GA;2020-04-07;154;7653;148;3;0;3
GA;2020-04-08;150;7803;147;2;0;1
GA;2020-04-09;159;7962;149;8;0;2
GA;2020-04-10;80;8042;71;9;0;0
GA;2020-04-11;66;8108;63;2;0;1
GA;2020-04-12;66;8174;62;3;0;1
GA;2020-04-13;110;8284;103;7;0;0
GA;2020-04-14;100;8384;64;34;0;2
GA;2020-04-15;199;8583;97;100;0;2
GA;2020-04-16;108;8691;69;36;0;3
GA;2020-04-17;98;8789;52;43;0;3
GA;2020-04-18;107;8896;62;45;0;0
GA;2020-04-19;57;8953;47;10;0;0
GA;2020-04-20;89;9042;62;23;0;4
GA;2020-04-21;98;9140;43;48;0;7
GA;2020-04-22;134;9274;48;75;0;11
GA;2020-04-23;124;9398;56;60;0;8
GA;2020-04-24;124;9522;38;79;0;7
GA;2020-04-25;36;9558;25;10;0;1
GA;2020-04-26;26;9584;16;8;0;2
GA;2020-04-27;57;9641;28;24;0;5
GA;2020-04-28;80;9721;20;51;0;9
GA;2020-04-29;113;9834;43;69;0;1
GA;2020-04-30;96;9930;24;58;0;14
GA;2020-05-01;108;10038;19;80;0;9
GA;2020-05-02;84;10122;23;46;0;15
GA;2020-05-03;45;10167;9;36;0;0
GA;2020-05-04;75;10242;13;49;0;13
GA;2020-05-05;137;10379;11;107;0;19
GA;2020-05-06;69;10448;24;39;1;5
GA;2020-05-07;53;10501;13;30;0;10
GA;2020-05-08;45;10546;9;28;0;8
GA;2020-05-09;24;10570;13;9;0;2
GA;2020-05-10;11;10581;8;3;0;0
GA;2020-05-11;8;10589;6;0;0;2
GA;2020-05-12;10;10599;9;0;1;0
GA;2020-05-13;10;10609;10;0;0;0
GA;2020-05-14;10;10619;9;1;0;0
GA;2020-05-15;13;10632;12;0;1;0
GA;2020-05-16;4;10636;4;0;0;0
GA;2020-05-17;8;10644;8;0;0;0
GA;2020-05-18;6;10650;6;0;0;0
GA;2020-05-19;5;10655;5;0;0;0
GA;2020-05-20;1;10656;1;0;0;0
GA;2020-05-21;2;10658;2;0;0;0
GA;2020-05-22;2;10660;2;0;0;0
GA;2020-05-23;4;10664;4;0;0;0
GA;2020-05-24;4;10668;4;0;0;0
GA;2020-05-25;2;10670;1;1;0;0
GA;2020-05-26;2;10672;2;0;0;0
GA;2020-05-27;1;10673;1;0;0;0
GA;2020-05-28;2;10675;2;0;0;0
GA;2020-05-29;2;10677;1;1;0;0
GA;2020-05-30;3;10680;3;0;0;0
GA;2020-05-31;1;10681;1;0;0;0
GA;2020-06-01;2;10683;2;0;0;0
GA;2020-06-02;2;10685;2;0;0;0
GA;2020-06-03;1;10686;1;0;0;0
GA;2020-06-04;3;10689;3;0;0;0
GA;2020-06-05;1;10690;1;0;0;0
GA;2020-06-06;1;10691;1;0;0;0
GA;2020-06-07;2;10693;1;0;0;1
GA;2020-06-08;2;10695;2;0;0;0
GA;2020-06-09;1;10696;1;0;0;0
GA;2020-06-10;0;10696;0;0;0;0
GA;2020-06-11;4;10700;4;0;0;0
GA;2020-06-12;2;10702;2;0;0;0
GA;2020-06-13;0;10702;0;0;0;0
GA;2020-06-14;6;10708;6;0;0;0
GA;2020-06-15;2;10710;2;0;0;0
GA;2020-06-16;0;10710;0;0;0;0
GA;2020-06-17;2;10712;2;0;0;0
GA;2020-06-18;9;10721;9;0;0;0
GA;2020-06-19;3;10724;3;0;0;0
GA;2020-06-20;6;10730;6;0;0;0
GA;2020-06-21;6;10736;6;0;0;0
GA;2020-06-22;6;10742;6;0;0;0
GA;2020-06-23;7;10749;7;0;0;0
GA;2020-06-24;5;10754;5;0;0;0
GA;2020-06-25;5;10759;5;0;0;0
GA;2020-06-26;20;10779;20;0;0;0
GA;2020-06-27;37;10816;37;0;0;0
GA;2020-06-28;19;10835;19;0;0;0
GA;2020-06-29;13;10848;13;0;0;0
GA;2020-06-30;6;10854;6;0;0;0
GA;2020-07-01;10;10864;10;0;0;0
GA;2020-07-02;2;10866;2;0;0;0
GA;2020-07-03;5;10871;5;0;0;0
GA;2020-07-04;2;10873;2;0;0;0
GA;2020-07-05;0;10873;0;0;0;0
IB;2020-01-31;0;0;0;0;0;0
IB;2020-02-01;0;0;0;0;0;0
IB;2020-02-02;0;0;0;0;0;0
IB;2020-02-03;0;0;0;0;0;0
IB;2020-02-04;0;0;0;0;0;0
IB;2020-02-05;0;0;0;0;0;0
IB;2020-02-06;0;0;0;0;0;0
IB;2020-02-07;0;0;0;0;0;0
IB;2020-02-08;0;0;0;0;0;0
IB;2020-02-09;0;0;0;0;0;0
IB;2020-02-10;2;2;2;0;0;0
IB;2020-02-11;0;2;0;0;0;0
IB;2020-02-12;0;2;0;0;0;0
IB;2020-02-13;0;2;0;0;0;0
IB;2020-02-14;1;3;1;0;0;0
IB;2020-02-15;0;3;0;0;0;0
IB;2020-02-16;0;3;0;0;0;0
IB;2020-02-17;0;3;0;0;0;0
IB;2020-02-18;0;3;0;0;0;0
IB;2020-02-19;0;3;0;0;0;0
IB;2020-02-20;1;4;0;1;0;0
IB;2020-02-21;0;4;0;0;0;0
IB;2020-02-22;0;4;0;0;0;0
IB;2020-02-23;0;4;0;0;0;0
IB;2020-02-24;0;4;0;0;0;0
IB;2020-02-25;0;4;0;0;0;0
IB;2020-02-26;1;5;0;1;0;0
IB;2020-02-27;4;9;4;0;0;0
IB;2020-02-28;4;13;1;0;0;3
IB;2020-02-29;2;15;2;0;0;0
IB;2020-03-01;4;19;4;0;0;0
IB;2020-03-02;6;25;6;0;0;0
IB;2020-03-03;7;32;7;0;0;0
IB;2020-03-04;5;37;5;0;0;0
IB;2020-03-05;12;49;12;0;0;0
IB;2020-03-06;10;59;10;0;0;0
IB;2020-03-07;7;66;6;1;0;0
IB;2020-03-08;14;80;12;1;0;1
IB;2020-03-09;17;97;16;1;0;0
IB;2020-03-10;36;133;34;2;0;0
IB;2020-03-11;42;175;41;1;0;0
IB;2020-03-12;42;217;39;2;0;1
IB;2020-03-13;61;278;61;0;0;0
IB;2020-03-14;71;349;68;3;0;0
IB;2020-03-15;85;434;83;1;0;1
IB;2020-03-16;88;522;84;1;0;3
IB;2020-03-17;82;604;79;3;0;0
IB;2020-03-18;81;685;80;1;0;0
IB;2020-03-19;105;790;102;2;0;1
IB;2020-03-20;97;887;95;2;0;0
IB;2020-03-21;62;949;61;1;0;0
IB;2020-03-22;91;1040;90;0;0;1
IB;2020-03-23;82;1122;79;3;0;0
IB;2020-03-24;66;1188;65;1;0;0
IB;2020-03-25;84;1272;80;3;0;1
IB;2020-03-26;73;1345;68;5;0;0
IB;2020-03-27;40;1385;37;2;0;1
IB;2020-03-28;36;1421;32;4;0;0
IB;2020-03-29;37;1458;36;1;0;0
IB;2020-03-30;66;1524;61;3;0;2
IB;2020-03-31;48;1572;45;3;0;0
IB;2020-04-01;84;1656;81;3;0;0
IB;2020-04-02;35;1691;34;1;0;0
IB;2020-04-03;47;1738;43;3;0;1
IB;2020-04-04;25;1763;23;2;0;0
IB;2020-04-05;30;1793;27;2;0;1
IB;2020-04-06;26;1819;21;5;0;0
IB;2020-04-07;19;1838;18;1;0;0
IB;2020-04-08;23;1861;22;1;0;0
IB;2020-04-09;11;1872;8;3;0;0
IB;2020-04-10;21;1893;17;4;0;0
IB;2020-04-11;15;1908;14;1;0;0
IB;2020-04-12;15;1923;15;0;0;0
IB;2020-04-13;15;1938;10;4;0;1
IB;2020-04-14;10;1948;8;2;0;0
IB;2020-04-15;9;1957;5;4;0;0
IB;2020-04-16;14;1971;14;0;0;0
IB;2020-04-17;11;1982;7;3;0;1
IB;2020-04-18;14;1996;12;2;0;0
IB;2020-04-19;10;2006;8;2;0;0
IB;2020-04-20;18;2024;14;3;0;1
IB;2020-04-21;11;2035;7;4;0;0
IB;2020-04-22;8;2043;5;2;0;1
IB;2020-04-23;5;2048;5;0;0;0
IB;2020-04-24;9;2057;8;1;0;0
IB;2020-04-25;11;2068;10;1;0;0
IB;2020-04-26;0;2068;0;0;0;0
IB;2020-04-27;3;2071;3;0;0;0
IB;2020-04-28;5;2076;4;0;0;1
IB;2020-04-29;3;2079;2;1;0;0
IB;2020-04-30;5;2084;5;0;0;0
IB;2020-05-01;10;2094;8;2;0;0
IB;2020-05-02;3;2097;1;2;0;0
IB;2020-05-03;4;2101;3;1;0;0
IB;2020-05-04;1;2102;1;0;0;0
IB;2020-05-05;10;2112;10;0;0;0
IB;2020-05-06;5;2117;5;0;0;0
IB;2020-05-07;11;2128;11;0;0;0
IB;2020-05-08;7;2135;7;0;0;0
IB;2020-05-09;6;2141;6;0;0;0
IB;2020-05-10;7;2148;6;1;0;0
IB;2020-05-11;3;2151;3;0;0;0
IB;2020-05-12;8;2159;8;0;0;0
IB;2020-05-13;8;2167;8;0;0;0
IB;2020-05-14;9;2176;9;0;0;0
IB;2020-05-15;12;2188;11;1;0;0
IB;2020-05-16;1;2189;1;0;0;0
IB;2020-05-17;6;2195;6;0;0;0
IB;2020-05-18;4;2199;4;0;0;0
IB;2020-05-19;7;2206;7;0;0;0
IB;2020-05-20;3;2209;3;0;0;0
IB;2020-05-21;6;2215;6;0;0;0
IB;2020-05-22;11;2226;11;0;0;0
IB;2020-05-23;4;2230;4;0;0;0
IB;2020-05-24;0;2230;0;0;0;0
IB;2020-05-25;2;2232;2;0;0;0
IB;2020-05-26;3;2235;3;0;0;0
IB;2020-05-27;5;2240;5;0;0;0
IB;2020-05-28;6;2246;5;1;0;0
IB;2020-05-29;4;2250;3;1;0;0
IB;2020-05-30;2;2252;2;0;0;0
IB;2020-05-31;3;2255;3;0;0;0
IB;2020-06-01;3;2258;2;1;0;0
IB;2020-06-02;3;2261;3;0;0;0
IB;2020-06-03;1;2262;1;0;0;0
IB;2020-06-04;3;2265;3;0;0;0
IB;2020-06-05;2;2267;2;0;0;0
IB;2020-06-06;4;2271;4;0;0;0
IB;2020-06-07;4;2275;4;0;0;0
IB;2020-06-08;3;2278;3;0;0;0
IB;2020-06-09;4;2282;4;0;0;0
IB;2020-06-10;3;2285;3;0;0;0
IB;2020-06-11;5;2290;5;0;0;0
IB;2020-06-12;6;2296;6;0;0;0
IB;2020-06-13;9;2305;9;0;0;0
IB;2020-06-14;3;2308;3;0;0;0
IB;2020-06-15;1;2309;1;0;0;0
IB;2020-06-16;4;2313;4;0;0;0
IB;2020-06-17;2;2315;2;0;0;0
IB;2020-06-18;1;2316;1;0;0;0
IB;2020-06-19;1;2317;1;0;0;0
IB;2020-06-20;9;2326;9;0;0;0
IB;2020-06-21;1;2327;1;0;0;0
IB;2020-06-22;4;2331;4;0;0;0
IB;2020-06-23;10;2341;10;0;0;0
IB;2020-06-24;4;2345;4;0;0;0
IB;2020-06-25;3;2348;3;0;0;0
IB;2020-06-26;4;2352;4;0;0;0
IB;2020-06-27;5;2357;5;0;0;0
IB;2020-06-28;5;2362;5;0;0;0
IB;2020-06-29;1;2363;1;0;0;0
IB;2020-06-30;1;2364;1;0;0;0
IB;2020-07-01;0;2364;0;0;0;0
IB;2020-07-02;0;2364;0;0;0;0
IB;2020-07-03;0;2364;0;0;0;0
IB;2020-07-04;0;2364;0;0;0;0
IB;2020-07-05;0;2364;0;0;0;0
MC;2020-01-31;0;0;0;0;0;0
MC;2020-02-01;0;0;0;0;0;0
MC;2020-02-02;0;0;0;0;0;0
MC;2020-02-03;0;0;0;0;0;0
MC;2020-02-04;0;0;0;0;0;0
MC;2020-02-05;2;2;0;2;0;0
MC;2020-02-06;0;2;0;0;0;0
MC;2020-02-07;0;2;0;0;0;0
MC;2020-02-08;0;2;0;0;0;0
MC;2020-02-09;0;2;0;0;0;0
MC;2020-02-10;1;3;0;1;0;0
MC;2020-02-11;0;3;0;0;0;0
MC;2020-02-12;0;3;0;0;0;0
MC;2020-02-13;0;3;0;0;0;0
MC;2020-02-14;1;4;0;1;0;0
MC;2020-02-15;0;4;0;0;0;0
MC;2020-02-16;0;4;0;0;0;0
MC;2020-02-17;3;7;0;3;0;0
MC;2020-02-18;1;8;0;1;0;0
MC;2020-02-19;1;9;0;1;0;0
MC;2020-02-20;0;9;0;0;0;0
MC;2020-02-21;0;9;0;0;0;0
MC;2020-02-22;1;10;1;0;0;0
MC;2020-02-23;1;11;1;0;0;0
MC;2020-02-24;2;13;1;1;0;0
MC;2020-02-25;3;16;1;2;0;0
MC;2020-02-26;1;17;0;1;0;0
MC;2020-02-27;1;18;1;0;0;0
MC;2020-02-28;3;21;1;2;0;0
MC;2020-02-29;3;24;2;1;0;0
MC;2020-03-01;5;29;4;1;0;0
MC;2020-03-02;8;37;6;2;0;0
MC;2020-03-03;6;43;3;3;0;0
MC;2020-03-04;11;54;5;6;0;0
MC;2020-03-05;14;68;10;4;0;0
MC;2020-03-06;13;81;10;3;0;0
MC;2020-03-07;20;101;15;5;0;0
MC;2020-03-08;19;120;14;5;0;0
MC;2020-03-09;32;152;23;9;0;0
MC;2020-03-10;64;216;48;16;0;0
MC;2020-03-11;74;290;56;17;0;1
MC;2020-03-12;62;352;40;21;0;1
MC;2020-03-13;104;456;70;33;0;1
MC;2020-03-14;108;564;80;28;0;0
MC;2020-03-15;96;660;70;26;0;0
MC;2020-03-16;130;790;98;32;0;0
MC;2020-03-17;103;893;79;24;0;0
MC;2020-03-18;120;1013;90;30;0;0
MC;2020-03-19;118;1131;78;40;0;0
MC;2020-03-20;122;1253;86;36;0;0
MC;2020-03-21;83;1336;67;15;0;1
MC;2020-03-22;79;1415;64;15;0;0
MC;2020-03-23;128;1543;100;28;0;0
MC;2020-03-24;78;1621;61;17;0;0
MC;2020-03-25;84;1705;65;17;0;2
MC;2020-03-26;46;1751;35;11;0;0
MC;2020-03-27;51;1802;35;14;0;2
MC;2020-03-28;40;1842;29;11;0;0
MC;2020-03-29;35;1877;23;12;0;0
MC;2020-03-30;41;1918;26;15;0;0
MC;2020-03-31;30;1948;23;7;0;0
MC;2020-04-01;28;1976;19;9;0;0
MC;2020-04-02;30;2006;21;9;0;0
MC;2020-04-03;26;2032;14;12;0;0
MC;2020-04-04;21;2053;18;3;0;0
MC;2020-04-05;29;2082;11;18;0;0
MC;2020-04-06;15;2097;6;9;0;0
MC;2020-04-07;10;2107;4;5;0;1
MC;2020-04-08;40;2147;16;24;0;0
MC;2020-04-09;26;2173;5;21;0;0
MC;2020-04-10;12;2185;5;7;0;0
MC;2020-04-11;12;2197;5;7;0;0
MC;2020-04-12;11;2208;4;4;0;3
MC;2020-04-13;7;2215;1;6;0;0
MC;2020-04-14;7;2222;5;2;0;0
MC;2020-04-15;9;2231;5;3;0;1
MC;2020-04-16;1;2232;0;1;0;0
MC;2020-04-17;6;2238;3;3;0;0
MC;2020-04-18;5;2243;0;5;0;0
MC;2020-04-19;4;2247;3;1;0;0
MC;2020-04-20;2;2249;1;1;0;0
MC;2020-04-21;6;2255;1;5;0;0
MC;2020-04-22;8;2263;3;5;0;0
MC;2020-04-23;12;2275;3;9;0;0
MC;2020-04-24;6;2281;0;6;0;0
MC;2020-04-25;3;2284;2;1;0;0
MC;2020-04-26;6;2290;3;3;0;0
MC;2020-04-27;1;2291;0;1;0;0
MC;2020-04-28;16;2307;0;16;0;0
MC;2020-04-29;10;2317;2;8;0;0
MC;2020-04-30;25;2342;1;24;0;0
MC;2020-05-01;8;2350;1;7;0;0
MC;2020-05-02;17;2367;1;16;0;0
MC;2020-05-03;4;2371;1;3;0;0
MC;2020-05-04;2;2373;1;1;0;0
MC;2020-05-05;3;2376;2;1;0;0
MC;2020-05-06;5;2381;5;0;0;0
MC;2020-05-07;4;2385;4;0;0;0
MC;2020-05-08;3;2388;3;0;0;0
MC;2020-05-09;1;2389;1;0;0;0
MC;2020-05-10;1;2390;1;0;0;0
MC;2020-05-11;2;2392;2;0;0;0
MC;2020-05-12;0;2392;0;0;0;0
MC;2020-05-13;4;2396;4;0;0;0
MC;2020-05-14;0;2396;0;0;0;0
MC;2020-05-15;0;2396;0;0;0;0
MC;2020-05-16;1;2397;1;0;0;0
MC;2020-05-17;1;2398;1;0;0;0
MC;2020-05-18;2;2400;2;0;0;0
MC;2020-05-19;1;2401;1;0;0;0
MC;2020-05-20;0;2401;0;0;0;0
MC;2020-05-21;2;2403;2;0;0;0
MC;2020-05-22;3;2406;3;0;0;0
MC;2020-05-23;2;2408;2;0;0;0
MC;2020-05-24;0;2408;0;0;0;0
MC;2020-05-25;0;2408;0;0;0;0
MC;2020-05-26;3;2411;3;0;0;0
MC;2020-05-27;4;2415;4;0;0;0
MC;2020-05-28;1;2416;1;0;0;0
MC;2020-05-29;1;2417;1;0;0;0
MC;2020-05-30;1;2418;1;0;0;0
MC;2020-05-31;0;2418;0;0;0;0
MC;2020-06-01;1;2419;1;0;0;0
MC;2020-06-02;2;2421;2;0;0;0
MC;2020-06-03;1;2422;1;0;0;0
MC;2020-06-04;1;2423;1;0;0;0
MC;2020-06-05;1;2424;1;0;0;0
MC;2020-06-06;3;2427;3;0;0;0
MC;2020-06-07;0;2427;0;0;0;0
MC;2020-06-08;0;2427;0;0;0;0
MC;2020-06-09;2;2429;2;0;0;0
MC;2020-06-10;2;2431;2;0;0;0
MC;2020-06-11;1;2432;1;0;0;0
MC;2020-06-12;1;2433;1;0;0;0
MC;2020-06-13;2;2435;2;0;0;0
MC;2020-06-14;5;2440;5;0;0;0
MC;2020-06-15;4;2444;4;0;0;0
MC;2020-06-16;0;2444;0;0;0;0
MC;2020-06-17;2;2446;2;0;0;0
MC;2020-06-18;3;2449;3;0;0;0
MC;2020-06-19;2;2451;2;0;0;0
MC;2020-06-20;4;2455;4;0;0;0
MC;2020-06-21;3;2458;3;0;0;0
MC;2020-06-22;5;2463;5;0;0;0
MC;2020-06-23;8;2471;8;0;0;0
MC;2020-06-24;7;2478;7;0;0;0
MC;2020-06-25;4;2482;4;0;0;0
MC;2020-06-26;1;2483;1;0;0;0
MC;2020-06-27;3;2486;3;0;0;0
MC;2020-06-28;3;2489;3;0;0;0
MC;2020-06-29;5;2494;5;0;0;0
MC;2020-06-30;1;2495;1;0;0;0
MC;2020-07-01;3;2498;3;0;0;0
MC;2020-07-02;1;2499;1;0;0;0
MC;2020-07-03;0;2499;0;0;0;0
MC;2020-07-04;0;2499;0;0;0;0
MC;2020-07-05;0;2499;0;0;0;0
MD;2020-01-31;4;4;4;0;0;0
MD;2020-02-01;9;13;9;0;0;0
MD;2020-02-02;6;19;6;0;0;0
MD;2020-02-03;7;26;7;0;0;0
MD;2020-02-04;3;29;3;0;0;0
MD;2020-02-05;4;33;4;0;0;0
MD;2020-02-06;4;37;4;0;0;0
MD;2020-02-07;9;46;9;0;0;0
MD;2020-02-08;8;54;8;0;0;0
MD;2020-02-09;2;56;2;0;0;0
MD;2020-02-10;10;66;10;0;0;0
MD;2020-02-11;8;74;8;0;0;0
MD;2020-02-12;9;83;9;0;0;0
MD;2020-02-13;15;98;15;0;0;0
MD;2020-02-14;11;109;11;0;0;0
MD;2020-02-15;13;122;13;0;0;0
MD;2020-02-16;14;136;14;0;0;0
MD;2020-02-17;19;155;19;0;0;0
MD;2020-02-18;14;169;14;0;0;0
MD;2020-02-19;12;181;12;0;0;0
MD;2020-02-20;22;203;22;0;0;0
MD;2020-02-21;27;230;27;0;0;0
MD;2020-02-22;29;259;29;0;0;0
MD;2020-02-23;44;303;44;0;0;0
MD;2020-02-24;57;360;57;0;0;0
MD;2020-02-25;50;410;50;0;0;0
MD;2020-02-26;68;478;68;0;0;0
MD;2020-02-27;94;572;94;0;0;0
MD;2020-02-28;162;734;162;0;0;0
MD;2020-02-29;107;841;107;0;0;0
MD;2020-03-01;320;1161;320;0;0;0
MD;2020-03-02;382;1543;382;0;0;0
MD;2020-03-03;394;1937;394;0;0;0
MD;2020-03-04;462;2399;462;0;0;0
MD;2020-03-05;650;3049;650;0;0;0
MD;2020-03-06;785;3834;785;0;0;0
MD;2020-03-07;839;4673;838;0;0;1
MD;2020-03-08;1051;5724;1051;0;0;0
MD;2020-03-09;1510;7234;1510;0;0;0
MD;2020-03-10;1974;9208;1974;0;0;0
MD;2020-03-11;1961;11169;1961;0;0;0
MD;2020-03-12;2331;13500;2331;0;0;0
MD;2020-03-13;2826;16326;2826;0;0;0
MD;2020-03-14;2544;18870;2543;0;0;1
MD;2020-03-15;2655;21525;2655;0;0;0
MD;2020-03-16;2951;24476;2950;0;0;1
MD;2020-03-17;2776;27252;2776;0;0;0
MD;2020-03-18;2626;29878;2626;0;0;0
MD;2020-03-19;2424;32302;2424;0;0;0
MD;2020-03-20;3090;35392;3090;0;0;0
MD;2020-03-21;1910;37302;1909;0;0;1
MD;2020-03-22;1641;38943;1640;0;0;1
MD;2020-03-23;2117;41060;2117;0;0;0
MD;2020-03-24;1980;43040;1980;0;0;0
MD;2020-03-25;1771;44811;1771;0;0;0
MD;2020-03-26;1544;46355;1544;0;0;0
MD;2020-03-27;1486;47841;1486;0;0;0
MD;2020-03-28;1246;49087;1246;0;0;0
MD;2020-03-29;865;49952;865;0;0;0
MD;2020-03-30;1081;51033;1081;0;0;0
MD;2020-03-31;1074;52107;1074;0;0;0
MD;2020-04-01;1338;53445;1338;0;0;0
MD;2020-04-02;1001;54446;1001;0;0;0
MD;2020-04-03;929;55375;929;0;0;0
MD;2020-04-04;710;56085;710;0;0;0
MD;2020-04-05;634;56719;634;0;0;0
MD;2020-04-06;624;57343;624;0;0;0
MD;2020-04-07;746;58089;746;0;0;0
MD;2020-04-08;680;58769;680;0;0;0
MD;2020-04-09;637;59406;637;0;0;0
MD;2020-04-10;708;60114;708;0;0;0
MD;2020-04-11;571;60685;571;0;0;0
MD;2020-04-12;495;61180;495;0;0;0
MD;2020-04-13;381;61561;380;0;0;1
MD;2020-04-14;492;62053;492;0;0;0
MD;2020-04-15;503;62556;502;0;0;1
MD;2020-04-16;596;63152;595;0;0;1
MD;2020-04-17;389;63541;389;0;0;0
MD;2020-04-18;466;64007;466;0;0;0
MD;2020-04-19;264;64271;264;0;0;0
MD;2020-04-20;278;64549;278;0;0;0
MD;2020-04-21;476;65025;476;0;0;0
MD;2020-04-22;457;65482;457;0;0;0
MD;2020-04-23;368;65850;368;0;0;0
MD;2020-04-24;237;66087;236;0;0;1
MD;2020-04-25;131;66218;131;0;0;0
MD;2020-04-26;123;66341;123;0;0;0
MD;2020-04-27;182;66523;182;0;0;0
MD;2020-04-28;230;66753;230;0;0;0
MD;2020-04-29;212;66965;212;0;0;0
MD;2020-04-30;173;67138;173;0;0;0
MD;2020-05-01;191;67329;191;0;0;0
MD;2020-05-02;165;67494;165;0;0;0
MD;2020-05-03;71;67565;71;0;0;0
MD;2020-05-04;93;67658;93;0;0;0
MD;2020-05-05;163;67821;162;0;0;1
MD;2020-05-06;177;67998;177;0;0;0
MD;2020-05-07;160;68158;160;0;0;0
MD;2020-05-08;146;68304;146;0;0;0
MD;2020-05-09;104;68408;104;0;0;0
MD;2020-05-10;55;68463;55;0;0;0
MD;2020-05-11;86;68549;86;0;0;0
MD;2020-05-12;104;68653;104;0;0;0
MD;2020-05-13;134;68787;133;0;0;1
MD;2020-05-14;121;68908;121;0;0;0
MD;2020-05-15;111;69019;111;0;0;0
MD;2020-05-16;79;69098;79;0;0;0
MD;2020-05-17;46;69144;46;0;0;0
MD;2020-05-18;63;69207;63;0;0;0
MD;2020-05-19;87;69294;87;0;0;0
MD;2020-05-20;124;69418;124;0;0;0
MD;2020-05-21;85;69503;85;0;0;0
MD;2020-05-22;121;69624;121;0;0;0
MD;2020-05-23;119;69743;119;0;0;0
MD;2020-05-24;44;69787;44;0;0;0
MD;2020-05-25;85;69872;85;0;0;0
MD;2020-05-26;109;69981;109;0;0;0
MD;2020-05-27;90;70071;90;0;0;0
MD;2020-05-28;131;70202;131;0;0;0
MD;2020-05-29;81;70283;81;0;0;0
MD;2020-05-30;92;70375;92;0;0;0
MD;2020-05-31;51;70426;51;0;0;0
MD;2020-06-01;70;70496;70;0;0;0
MD;2020-06-02;103;70599;103;0;0;0
MD;2020-06-03;79;70678;79;0;0;0
MD;2020-06-04;91;70769;91;0;0;0
MD;2020-06-05;89;70858;89;0;0;0
MD;2020-06-06;112;70970;112;0;0;0
MD;2020-06-07;27;70997;27;0;0;0
MD;2020-06-08;47;71044;47;0;0;0
MD;2020-06-09;93;71137;93;0;0;0
MD;2020-06-10;70;71207;70;0;0;0
MD;2020-06-11;68;71275;68;0;0;0
MD;2020-06-12;83;71358;83;0;0;0
MD;2020-06-13;50;71408;50;0;0;0
MD;2020-06-14;47;71455;47;0;0;0
MD;2020-06-15;40;71495;40;0;0;0
MD;2020-06-16;32;71527;32;0;0;0
MD;2020-06-17;53;71580;53;0;0;0
MD;2020-06-18;42;71622;42;0;0;0
MD;2020-06-19;58;71680;58;0;0;0
MD;2020-06-20;55;71735;55;0;0;0
MD;2020-06-21;34;71769;34;0;0;0
MD;2020-06-22;19;71788;19;0;0;0
MD;2020-06-23;47;71835;47;0;0;0
MD;2020-06-24;52;71887;52;0;0;0
MD;2020-06-25;37;71924;37;0;0;0
MD;2020-06-26;40;71964;40;0;0;0
MD;2020-06-27;54;72018;54;0;0;0
MD;2020-06-28;22;72040;22;0;0;0
MD;2020-06-29;32;72072;32;0;0;0
MD;2020-06-30;30;72102;30;0;0;0
MD;2020-07-01;14;72116;14;0;0;0
MD;2020-07-02;7;72123;7;0;0;0
MD;2020-07-03;5;72128;5;0;0;0
MD;2020-07-04;6;72134;6;0;0;0
MD;2020-07-05;3;72137;3;0;0;0
ML;2020-01-31;0;0;0;0;0;0
ML;2020-02-01;0;0;0;0;0;0
ML;2020-02-02;0;0;0;0;0;0
ML;2020-02-03;0;0;0;0;0;0
ML;2020-02-04;0;0;0;0;0;0
ML;2020-02-05;0;0;0;0;0;0
ML;2020-02-06;0;0;0;0;0;0
ML;2020-02-07;0;0;0;0;0;0
ML;2020-02-08;0;0;0;0;0;0
ML;2020-02-09;0;0;0;0;0;0
ML;2020-02-10;0;0;0;0;0;0
ML;2020-02-11;0;0;0;0;0;0
ML;2020-02-12;0;0;0;0;0;0
ML;2020-02-13;0;0;0;0;0;0
ML;2020-02-14;0;0;0;0;0;0
ML;2020-02-15;0;0;0;0;0;0
ML;2020-02-16;0;0;0;0;0;0
ML;2020-02-17;0;0;0;0;0;0
ML;2020-02-18;0;0;0;0;0;0
ML;2020-02-19;0;0;0;0;0;0
ML;2020-02-20;0;0;0;0;0;0
ML;2020-02-21;0;0;0;0;0;0
ML;2020-02-22;0;0;0;0;0;0
ML;2020-02-23;0;0;0;0;0;0
ML;2020-02-24;0;0;0;0;0;0
ML;2020-02-25;0;0;0;0;0;0
ML;2020-02-26;0;0;0;0;0;0
ML;2020-02-27;0;0;0;0;0;0
ML;2020-02-28;0;0;0;0;0;0
ML;2020-02-29;0;0;0;0;0;0
ML;2020-03-01;0;0;0;0;0;0
ML;2020-03-02;0;0;0;0;0;0
ML;2020-03-03;0;0;0;0;0;0
ML;2020-03-04;0;0;0;0;0;0
ML;2020-03-05;1;1;1;0;0;0
ML;2020-03-06;1;2;1;0;0;0
ML;2020-03-07;3;5;3;0;0;0
ML;2020-03-08;1;6;1;0;0;0
ML;2020-03-09;2;8;2;0;0;0
ML;2020-03-10;5;13;5;0;0;0
ML;2020-03-11;4;17;3;0;0;1
ML;2020-03-12;3;20;1;1;0;1
ML;2020-03-13;10;30;9;1;0;0
ML;2020-03-14;4;34;3;1;0;0
ML;2020-03-15;3;37;3;0;0;0
ML;2020-03-16;6;43;2;2;1;1
ML;2020-03-17;3;46;3;0;0;0
ML;2020-03-18;6;52;5;0;0;1
ML;2020-03-19;6;58;3;1;0;2
ML;2020-03-20;4;62;4;0;0;0
ML;2020-03-21;3;65;1;0;0;2
ML;2020-03-22;5;70;4;0;0;1
ML;2020-03-23;5;75;4;0;0;1
ML;2020-03-24;1;76;1;0;0;0
ML;2020-03-25;4;80;3;1;0;0
ML;2020-03-26;6;86;5;1;0;0
ML;2020-03-27;5;91;3;0;0;2
ML;2020-03-28;4;95;3;1;0;0
ML;2020-03-29;5;100;4;0;0;1
ML;2020-03-30;3;103;3;0;0;0
ML;2020-03-31;3;106;3;0;0;0
ML;2020-04-01;5;111;5;0;0;0
ML;2020-04-02;3;114;3;0;0;0
ML;2020-04-03;4;118;3;1;0;0
ML;2020-04-04;3;121;2;1;0;0
ML;2020-04-05;1;122;0;1;0;0
ML;2020-04-06;0;122;0;0;0;0
ML;2020-04-07;2;124;2;0;0;0
ML;2020-04-08;0;124;0;0;0;0
ML;2020-04-09;0;124;0;0;0;0
ML;2020-04-10;1;125;1;0;0;0
ML;2020-04-11;0;125;0;0;0;0
ML;2020-04-12;1;126;1;0;0;0
ML;2020-04-13;1;127;1;0;0;0
ML;2020-04-14;0;127;0;0;0;0
ML;2020-04-15;0;127;0;0;0;0
ML;2020-04-16;0;127;0;0;0;0
ML;2020-04-17;0;127;0;0;0;0
ML;2020-04-18;0;127;0;0;0;0
ML;2020-04-19;0;127;0;0;0;0
ML;2020-04-20;2;129;2;0;0;0
ML;2020-04-21;0;129;0;0;0;0
ML;2020-04-22;1;130;1;0;0;0
ML;2020-04-23;0;130;0;0;0;0
ML;2020-04-24;1;131;1;0;0;0
ML;2020-04-25;1;132;1;0;0;0
ML;2020-04-26;0;132;0;0;0;0
ML;2020-04-27;0;132;0;0;0;0
ML;2020-04-28;0;132;0;0;0;0
ML;2020-04-29;1;133;1;0;0;0
ML;2020-04-30;1;134;1;0;0;0
ML;2020-05-01;0;134;0;0;0;0
ML;2020-05-02;0;134;0;0;0;0
ML;2020-05-03;0;134;0;0;0;0
ML;2020-05-04;0;134;0;0;0;0
ML;2020-05-05;0;134;0;0;0;0
ML;2020-05-06;0;134;0;0;0;0
ML;2020-05-07;0;134;0;0;0;0
ML;2020-05-08;0;134;0;0;0;0
ML;2020-05-09;0;134;0;0;0;0
ML;2020-05-10;0;134;0;0;0;0
ML;2020-05-11;0;134;0;0;0;0
ML;2020-05-12;0;134;0;0;0;0
ML;2020-05-13;0;134;0;0;0;0
ML;2020-05-14;0;134;0;0;0;0
ML;2020-05-15;0;134;0;0;0;0
ML;2020-05-16;0;134;0;0;0;0
ML;2020-05-17;0;134;0;0;0;0
ML;2020-05-18;1;135;1;0;0;0
ML;2020-05-19;0;135;0;0;0;0
ML;2020-05-20;0;135;0;0;0;0
ML;2020-05-21;0;135;0;0;0;0
ML;2020-05-22;0;135;0;0;0;0
ML;2020-05-23;0;135;0;0;0;0
ML;2020-05-24;0;135;0;0;0;0
ML;2020-05-25;0;135;0;0;0;0
ML;2020-05-26;1;136;1;0;0;0
ML;2020-05-27;0;136;0;0;0;0
ML;2020-05-28;0;136;0;0;0;0
ML;2020-05-29;0;136;0;0;0;0
ML;2020-05-30;0;136;0;0;0;0
ML;2020-05-31;0;136;0;0;0;0
ML;2020-06-01;0;136;0;0;0;0
ML;2020-06-02;0;136;0;0;0;0
ML;2020-06-03;0;136;0;0;0;0
ML;2020-06-04;0;136;0;0;0;0
ML;2020-06-05;0;136;0;0;0;0
ML;2020-06-06;0;136;0;0;0;0
ML;2020-06-07;0;136;0;0;0;0
ML;2020-06-08;0;136;0;0;0;0
ML;2020-06-09;1;137;1;0;0;0
ML;2020-06-10;0;137;0;0;0;0
ML;2020-06-11;0;137;0;0;0;0
ML;2020-06-12;0;137;0;0;0;0
ML;2020-06-13;0;137;0;0;0;0
ML;2020-06-14;0;137;0;0;0;0
ML;2020-06-15;2;139;0;0;0;2
ML;2020-06-16;0;139;0;0;0;0
ML;2020-06-17;0;139;0;0;0;0
ML;2020-06-18;0;139;0;0;0;0
ML;2020-06-19;0;139;0;0;0;0
ML;2020-06-20;0;139;0;0;0;0
ML;2020-06-21;0;139;0;0;0;0
ML;2020-06-22;0;139;0;0;0;0
ML;2020-06-23;0;139;0;0;0;0
ML;2020-06-24;0;139;0;0;0;0
ML;2020-06-25;0;139;0;0;0;0
ML;2020-06-26;0;139;0;0;0;0
ML;2020-06-27;0;139;0;0;0;0
ML;2020-06-28;0;139;0;0;0;0
ML;2020-06-29;0;139;0;0;0;0
ML;2020-06-30;0;139;0;0;0;0
ML;2020-07-01;0;139;0;0;0;0
ML;2020-07-02;0;139;0;0;0;0
ML;2020-07-03;0;139;0;0;0;0
ML;2020-07-04;0;139;0;0;0;0
ML;2020-07-05;0;139;0;0;0;0
NC;2020-01-31;0;0;0;0;0;0
NC;2020-02-01;0;0;0;0;0;0
NC;2020-02-02;0;0;0;0;0;0
NC;2020-02-03;0;0;0;0;0;0
NC;2020-02-04;1;1;0;1;0;0
NC;2020-02-05;0;1;0;0;0;0
NC;2020-02-06;0;1;0;0;0;0
NC;2020-02-07;0;1;0;0;0;0
NC;2020-02-08;0;1;0;0;0;0
NC;2020-02-09;0;1;0;0;0;0
NC;2020-02-10;1;2;1;0;0;0
NC;2020-02-11;0;2;0;0;0;0
NC;2020-02-12;0;2;0;0;0;0
NC;2020-02-13;0;2;0;0;0;0
NC;2020-02-14;0;2;0;0;0;0
NC;2020-02-15;0;2;0;0;0;0
NC;2020-02-16;0;2;0;0;0;0
NC;2020-02-17;0;2;0;0;0;0
NC;2020-02-18;0;2;0;0;0;0
NC;2020-02-19;0;2;0;0;0;0
NC;2020-02-20;1;3;0;1;0;0
NC;2020-02-21;2;5;1;1;0;0
NC;2020-02-22;1;6;1;0;0;0
NC;2020-02-23;1;7;1;0;0;0
NC;2020-02-24;3;10;3;0;0;0
NC;2020-02-25;4;14;2;2;0;0
NC;2020-02-26;5;19;2;3;0;0
NC;2020-02-27;5;24;4;1;0;0
NC;2020-02-28;3;27;2;1;0;0
NC;2020-02-29;5;32;4;1;0;0
NC;2020-03-01;13;45;8;5;0;0
NC;2020-03-02;15;60;11;4;0;0
NC;2020-03-03;18;78;14;4;0;0
NC;2020-03-04;22;100;18;4;0;0
NC;2020-03-05;28;128;19;9;0;0
NC;2020-03-06;26;154;19;7;0;0
NC;2020-03-07;49;203;42;7;0;0
NC;2020-03-08;51;254;38;13;0;0
NC;2020-03-09;97;351;77;20;0;0
NC;2020-03-10;109;460;84;25;0;0
NC;2020-03-11;130;590;109;21;0;0
NC;2020-03-12;182;772;140;42;0;0
NC;2020-03-13;211;983;138;73;0;0
NC;2020-03-14;177;1160;121;56;0;0
NC;2020-03-15;262;1422;166;96;0;0
NC;2020-03-16;274;1696;156;118;0;0
NC;2020-03-17;267;1963;169;98;0;0
NC;2020-03-18;250;2213;176;74;0;0
NC;2020-03-19;233;2446;153;80;0;0
NC;2020-03-20;326;2772;228;98;0;0
NC;2020-03-21;206;2978;152;54;0;0
NC;2020-03-22;194;3172;141;53;0;0
NC;2020-03-23;242;3414;161;81;0;0
NC;2020-03-24;278;3692;198;80;0;0
NC;2020-03-25;242;3934;182;60;0;0
NC;2020-03-26;167;4101;117;50;0;0
NC;2020-03-27;161;4262;115;46;0;0
NC;2020-03-28;140;4402;108;32;0;0
NC;2020-03-29;96;4498;79;17;0;0
NC;2020-03-30;245;4743;211;34;0;0
NC;2020-03-31;151;4894;125;26;0;0
NC;2020-04-01;233;5127;195;38;0;0
NC;2020-04-02;144;5271;126;18;0;0
NC;2020-04-03;138;5409;126;12;0;0
NC;2020-04-04;88;5497;76;12;0;0
NC;2020-04-05;101;5598;86;15;0;0
NC;2020-04-06;149;5747;132;17;0;0
NC;2020-04-07;118;5865;84;34;0;0
NC;2020-04-08;118;5983;92;26;0;0
NC;2020-04-09;112;6095;79;33;0;0
NC;2020-04-10;106;6201;69;37;0;0
NC;2020-04-11;84;6285;45;39;0;0
NC;2020-04-12;90;6375;59;31;0;0
NC;2020-04-13;87;6462;56;31;0;0
NC;2020-04-14;100;6562;48;52;0;0
NC;2020-04-15;78;6640;35;43;0;0
NC;2020-04-16;61;6701;30;31;0;0
NC;2020-04-17;86;6787;44;42;0;0
NC;2020-04-18;65;6852;39;26;0;0
NC;2020-04-19;46;6898;35;11;0;0
NC;2020-04-20;63;6961;31;32;0;0
NC;2020-04-21;30;6991;11;19;0;0
NC;2020-04-22;53;7044;21;32;0;0
NC;2020-04-23;56;7100;19;37;0;0
NC;2020-04-24;62;7162;21;41;0;0
NC;2020-04-25;39;7201;21;18;0;0
NC;2020-04-26;12;7213;8;4;0;0
NC;2020-04-27;23;7236;20;3;0;0
NC;2020-04-28;32;7268;13;19;0;0
NC;2020-04-29;50;7318;18;32;0;0
NC;2020-04-30;57;7375;16;41;0;0
NC;2020-05-01;72;7447;21;51;0;0
NC;2020-05-02;70;7517;16;54;0;0
NC;2020-05-03;23;7540;10;13;0;0
NC;2020-05-04;20;7560;13;7;0;0
NC;2020-05-05;8;7568;8;0;0;0
NC;2020-05-06;10;7578;8;2;0;0
NC;2020-05-07;7;7585;7;0;0;0
NC;2020-05-08;22;7607;22;0;0;0
NC;2020-05-09;10;7617;9;1;0;0
NC;2020-05-10;8;7625;7;1;0;0
NC;2020-05-11;27;7652;27;0;0;0
NC;2020-05-12;4;7656;4;0;0;0
NC;2020-05-13;10;7666;10;0;0;0
NC;2020-05-14;5;7671;5;0;0;0
NC;2020-05-15;5;7676;5;0;0;0
NC;2020-05-16;4;7680;4;0;0;0
NC;2020-05-17;12;7692;12;0;0;0
NC;2020-05-18;5;7697;5;0;0;0
NC;2020-05-19;7;7704;7;0;0;0
NC;2020-05-20;5;7709;5;0;0;0
NC;2020-05-21;14;7723;14;0;0;0
NC;2020-05-22;10;7733;10;0;0;0
NC;2020-05-23;7;7740;7;0;0;0
NC;2020-05-24;5;7745;5;0;0;0
NC;2020-05-25;4;7749;4;0;0;0
NC;2020-05-26;1;7750;1;0;0;0
NC;2020-05-27;2;7752;2;0;0;0
NC;2020-05-28;5;7757;5;0;0;0
NC;2020-05-29;6;7763;6;0;0;0
NC;2020-05-30;7;7770;7;0;0;0
NC;2020-05-31;1;7771;1;0;0;0
NC;2020-06-01;1;7772;1;0;0;0
NC;2020-06-02;1;7773;1;0;0;0
NC;2020-06-03;5;7778;5;0;0;0
NC;2020-06-04;4;7782;4;0;0;0
NC;2020-06-05;3;7785;3;0;0;0
NC;2020-06-06;1;7786;1;0;0;0
NC;2020-06-07;2;7788;2;0;0;0
NC;2020-06-08;0;7788;0;0;0;0
NC;2020-06-09;3;7791;3;0;0;0
NC;2020-06-10;6;7797;6;0;0;0
NC;2020-06-11;2;7799;2;0;0;0
NC;2020-06-12;3;7802;3;0;0;0
NC;2020-06-13;4;7806;4;0;0;0
NC;2020-06-14;4;7810;4;0;0;0
NC;2020-06-15;18;7828;18;0;0;0
NC;2020-06-16;16;7844;16;0;0;0
NC;2020-06-17;8;7852;8;0;0;0
NC;2020-06-18;6;7858;6;0;0;0
NC;2020-06-19;6;7864;6;0;0;0
NC;2020-06-20;4;7868;4;0;0;0
NC;2020-06-21;8;7876;8;0;0;0
NC;2020-06-22;9;7885;9;0;0;0
NC;2020-06-23;4;7889;4;0;0;0
NC;2020-06-24;5;7894;5;0;0;0
NC;2020-06-25;8;7902;8;0;0;0
NC;2020-06-26;4;7906;4;0;0;0
NC;2020-06-27;3;7909;3;0;0;0
NC;2020-06-28;2;7911;2;0;0;0
NC;2020-06-29;2;7913;2;0;0;0
NC;2020-06-30;1;7914;1;0;0;0
NC;2020-07-01;1;7915;1;0;0;0
NC;2020-07-02;1;7916;1;0;0;0
NC;2020-07-03;3;7919;3;0;0;0
NC;2020-07-04;1;7920;1;0;0;0
NC;2020-07-05;1;7921;1;0;0;0
PV;2020-01-31;0;0;0;0;0;0
PV;2020-02-01;0;0;0;0;0;0
PV;2020-02-02;0;0;0;0;0;0
PV;2020-02-03;0;0;0;0;0;0
PV;2020-02-04;0;0;0;0;0;0
PV;2020-02-05;0;0;0;0;0;0
PV;2020-02-06;0;0;0;0;0;0
PV;2020-02-07;0;0;0;0;0;0
PV;2020-02-08;0;0;0;0;0;0
PV;2020-02-09;1;1;0;0;0;1
PV;2020-02-10;0;1;0;0;0;0
PV;2020-02-11;0;1;0;0;0;0
PV;2020-02-12;2;3;2;0;0;0
PV;2020-02-13;0;3;0;0;0;0
PV;2020-02-14;0;3;0;0;0;0
PV;2020-02-15;3;6;3;0;0;0
PV;2020-02-16;1;7;1;0;0;0
PV;2020-02-17;2;9;2;0;0;0
PV;2020-02-18;0;9;0;0;0;0
PV;2020-02-19;1;10;1;0;0;0
PV;2020-02-20;1;11;1;0;0;0
PV;2020-02-21;3;14;3;0;0;0
PV;2020-02-22;3;17;3;0;0;0
PV;2020-02-23;1;18;1;0;0;0
PV;2020-02-24;6;24;6;0;0;0
PV;2020-02-25;12;36;11;0;0;1
PV;2020-02-26;10;46;10;0;0;0
PV;2020-02-27;14;60;13;0;0;1
PV;2020-02-28;33;93;31;0;0;2
PV;2020-02-29;24;117;24;0;0;0
PV;2020-03-01;47;164;47;0;0;0
PV;2020-03-02;56;220;54;0;0;2
PV;2020-03-03;57;277;57;0;0;0
PV;2020-03-04;68;345;68;0;0;0
PV;2020-03-05;75;420;74;0;0;1
PV;2020-03-06;81;501;80;0;0;1
PV;2020-03-07;92;593;87;0;0;5
PV;2020-03-08;101;694;98;0;0;3
PV;2020-03-09;143;837;140;0;0;3
PV;2020-03-10;227;1064;225;0;0;2
PV;2020-03-11;226;1290;219;0;0;7
PV;2020-03-12;272;1562;264;0;0;8
PV;2020-03-13;426;1988;407;0;0;19
PV;2020-03-14;419;2407;409;0;0;10
PV;2020-03-15;431;2838;415;0;0;16
PV;2020-03-16;597;3435;575;0;0;22
PV;2020-03-17;538;3973;518;0;0;20
PV;2020-03-18;553;4526;544;0;0;9
PV;2020-03-19;465;4991;448;0;0;17
PV;2020-03-20;611;5602;581;0;0;30
PV;2020-03-21;433;6035;423;0;0;10
PV;2020-03-22;393;6428;383;0;0;10
PV;2020-03-23;483;6911;460;0;0;23
PV;2020-03-24;396;7307;377;0;0;19
PV;2020-03-25;409;7716;389;0;0;20
PV;2020-03-26;364;8080;350;0;0;14
PV;2020-03-27;397;8477;386;0;0;11
PV;2020-03-28;290;8767;279;0;0;11
PV;2020-03-29;268;9035;240;0;0;28
PV;2020-03-30;321;9356;304;0;0;17
PV;2020-03-31;266;9622;247;0;0;19
PV;2020-04-01;288;9910;266;0;0;22
PV;2020-04-02;256;10166;239;0;0;17
PV;2020-04-03;330;10496;309;0;0;21
PV;2020-04-04;215;10711;200;0;0;15
PV;2020-04-05;229;10940;218;0;0;11
PV;2020-04-06;298;11238;284;0;0;14
PV;2020-04-07;241;11479;223;0;0;18
PV;2020-04-08;243;11722;218;0;0;25
PV;2020-04-09;214;11936;192;0;0;22
PV;2020-04-10;199;12135;176;0;0;23
PV;2020-04-11;140;12275;124;0;0;16
PV;2020-04-12;153;12428;142;0;0;11
PV;2020-04-13;130;12558;109;0;0;21
PV;2020-04-14;104;12662;89;0;0;15
PV;2020-04-15;109;12771;99;0;0;10
PV;2020-04-16;128;12899;108;0;0;20
PV;2020-04-17;150;13049;132;0;0;18
PV;2020-04-18;108;13157;97;0;0;11
PV;2020-04-19;54;13211;50;0;0;4
PV;2020-04-20;82;13293;78;0;0;4
PV;2020-04-21;78;13371;70;0;0;8
PV;2020-04-22;65;13436;49;0;0;16
PV;2020-04-23;66;13502;58;0;0;8
PV;2020-04-24;97;13599;85;0;0;12
PV;2020-04-25;47;13646;38;0;0;9
PV;2020-04-26;42;13688;31;0;0;11
PV;2020-04-27;30;13718;28;0;0;2
PV;2020-04-28;49;13767;38;0;0;11
PV;2020-04-29;39;13806;31;0;0;8
PV;2020-04-30;33;13839;26;0;0;7
PV;2020-05-01;40;13879;31;0;0;9
PV;2020-05-02;50;13929;41;0;0;9
PV;2020-05-03;35;13964;28;0;0;7
PV;2020-05-04;18;13982;13;0;0;5
PV;2020-05-05;31;14013;29;0;0;2
PV;2020-05-06;32;14045;21;0;0;11
PV;2020-05-07;38;14083;27;0;0;11
PV;2020-05-08;34;14117;26;0;0;8
PV;2020-05-09;28;14145;21;0;0;7
PV;2020-05-10;13;14158;9;0;0;4
PV;2020-05-11;15;14173;14;0;0;1
PV;2020-05-12;23;14196;19;0;0;4
PV;2020-05-13;20;14216;17;0;0;3
PV;2020-05-14;14;14230;10;0;0;4
PV;2020-05-15;13;14243;10;0;0;3
PV;2020-05-16;17;14260;8;0;0;9
PV;2020-05-17;7;14267;7;0;0;0
PV;2020-05-18;8;14275;5;0;0;3
PV;2020-05-19;4;14279;4;0;0;0
PV;2020-05-20;9;14288;7;0;0;2
PV;2020-05-21;5;14293;3;0;0;2
PV;2020-05-22;9;14302;6;0;0;3
PV;2020-05-23;5;14307;4;0;0;1
PV;2020-05-24;4;14311;3;0;0;1
PV;2020-05-25;4;14315;4;0;0;0
PV;2020-05-26;7;14322;6;0;0;1
PV;2020-05-27;4;14326;4;0;0;0
PV;2020-05-28;7;14333;5;0;0;2
PV;2020-05-29;2;14335;1;0;0;1
PV;2020-05-30;6;14341;2;0;0;4
PV;2020-05-31;4;14345;4;0;0;0
PV;2020-06-01;9;14354;9;0;0;0
PV;2020-06-02;14;14368;13;0;0;1
PV;2020-06-03;12;14380;9;0;0;3
PV;2020-06-04;13;14393;11;0;0;2
PV;2020-06-05;17;14410;15;0;0;2
PV;2020-06-06;22;14432;20;0;0;2
PV;2020-06-07;22;14454;14;0;0;8
PV;2020-06-08;15;14469;14;0;0;1
PV;2020-06-09;14;14483;13;0;0;1
PV;2020-06-10;8;14491;8;0;0;0
PV;2020-06-11;8;14499;8;0;0;0
PV;2020-06-12;8;14507;8;0;0;0
PV;2020-06-13;9;14516;9;0;0;0
PV;2020-06-14;3;14519;3;0;0;0
PV;2020-06-15;11;14530;11;0;0;0
PV;2020-06-16;8;14538;8;0;0;0
PV;2020-06-17;6;14544;6;0;0;0
PV;2020-06-18;17;14561;17;0;0;0
PV;2020-06-19;8;14569;8;0;0;0
PV;2020-06-20;7;14576;7;0;0;0
PV;2020-06-21;4;14580;4;0;0;0
PV;2020-06-22;6;14586;6;0;0;0
PV;2020-06-23;4;14590;4;0;0;0
PV;2020-06-24;12;14602;12;0;0;0
PV;2020-06-25;2;14604;2;0;0;0
PV;2020-06-26;11;14615;11;0;0;0
PV;2020-06-27;7;14622;7;0;0;0
PV;2020-06-28;8;14630;8;0;0;0
PV;2020-06-29;9;14639;9;0;0;0
PV;2020-06-30;7;14646;7;0;0;0
PV;2020-07-01;3;14649;3;0;0;0
PV;2020-07-02;1;14650;1;0;0;0
PV;2020-07-03;4;14654;4;0;0;0
PV;2020-07-04;1;14655;1;0;0;0
PV;2020-07-05;2;14657;2;0;0;0
RI;2020-01-31;0;0;0;0;0;0
RI;2020-02-01;0;0;0;0;0;0
RI;2020-02-02;0;0;0;0;0;0
RI;2020-02-03;1;1;1;0;0;0
RI;2020-02-04;0;1;0;0;0;0
RI;2020-02-05;0;1;0;0;0;0
RI;2020-02-06;0;1;0;0;0;0
RI;2020-02-07;0;1;0;0;0;0
RI;2020-02-08;0;1;0;0;0;0
RI;2020-02-09;0;1;0;0;0;0
RI;2020-02-10;0;1;0;0;0;0
RI;2020-02-11;0;1;0;0;0;0
RI;2020-02-12;0;1;0;0;0;0
RI;2020-02-13;0;1;0;0;0;0
RI;2020-02-14;0;1;0;0;0;0
RI;2020-02-15;0;1;0;0;0;0
RI;2020-02-16;0;1;0;0;0;0
RI;2020-02-17;0;1;0;0;0;0
RI;2020-02-18;0;1;0;0;0;0
RI;2020-02-19;0;1;0;0;0;0
RI;2020-02-20;0;1;0;0;0;0
RI;2020-02-21;1;2;1;0;0;0
RI;2020-02-22;0;2;0;0;0;0
RI;2020-02-23;1;3;1;0;0;0
RI;2020-02-24;2;5;2;0;0;0
RI;2020-02-25;2;7;2;0;0;0
RI;2020-02-26;4;11;4;0;0;0
RI;2020-02-27;9;20;8;1;0;0
RI;2020-02-28;10;30;10;0;0;0
RI;2020-02-29;13;43;13;0;0;0
RI;2020-03-01;22;65;22;0;0;0
RI;2020-03-02;30;95;29;1;0;0
RI;2020-03-03;28;123;27;1;0;0
RI;2020-03-04;25;148;25;0;0;0
RI;2020-03-05;27;175;27;0;0;0
RI;2020-03-06;45;220;44;1;0;0
RI;2020-03-07;39;259;39;0;0;0
RI;2020-03-08;41;300;41;0;0;0
RI;2020-03-09;60;360;59;1;0;0
RI;2020-03-10;88;448;88;0;0;0
RI;2020-03-11;70;518;68;2;0;0
RI;2020-03-12;74;592;72;2;0;0
RI;2020-03-13;107;699;106;1;0;0
RI;2020-03-14;138;837;136;2;0;0
RI;2020-03-15;111;948;109;2;0;0
RI;2020-03-16;157;1105;154;3;0;0
RI;2020-03-17;122;1227;117;5;0;0
RI;2020-03-18;143;1370;142;1;0;0
RI;2020-03-19;168;1538;167;1;0;0
RI;2020-03-20;191;1729;190;1;0;0
RI;2020-03-21;133;1862;133;0;0;0
RI;2020-03-22;108;1970;108;0;0;0
RI;2020-03-23;158;2128;155;3;0;0
RI;2020-03-24;118;2246;118;0;0;0
RI;2020-03-25;131;2377;130;1;0;0
RI;2020-03-26;114;2491;112;2;0;0
RI;2020-03-27;129;2620;126;2;0;1
RI;2020-03-28;100;2720;100;0;0;0
RI;2020-03-29;87;2807;85;2;0;0
RI;2020-03-30;117;2924;116;1;0;0
RI;2020-03-31;108;3032;105;3;0;0
RI;2020-04-01;108;3140;107;1;0;0
RI;2020-04-02;100;3240;99;1;0;0
RI;2020-04-03;79;3319;75;4;0;0
RI;2020-04-04;55;3374;53;2;0;0
RI;2020-04-05;36;3410;35;1;0;0
RI;2020-04-06;41;3451;41;0;0;0
RI;2020-04-07;52;3503;51;1;0;0
RI;2020-04-08;45;3548;39;6;0;0
RI;2020-04-09;44;3592;42;2;0;0
RI;2020-04-10;40;3632;39;1;0;0
RI;2020-04-11;25;3657;23;2;0;0
RI;2020-04-12;22;3679;22;0;0;0
RI;2020-04-13;29;3708;25;4;0;0
RI;2020-04-14;24;3732;24;0;0;0
RI;2020-04-15;16;3748;14;2;0;0
RI;2020-04-16;29;3777;28;1;0;0
RI;2020-04-17;25;3802;23;2;0;0
RI;2020-04-18;17;3819;17;0;0;0
RI;2020-04-19;14;3833;14;0;0;0
RI;2020-04-20;9;3842;9;0;0;0
RI;2020-04-21;6;3848;4;2;0;0
RI;2020-04-22;15;3863;14;1;0;0
RI;2020-04-23;13;3876;13;0;0;0
RI;2020-04-24;4;3880;3;1;0;0
RI;2020-04-25;5;3885;5;0;0;0
RI;2020-04-26;4;3889;2;2;0;0
RI;2020-04-27;4;3893;4;0;0;0
RI;2020-04-28;10;3903;10;0;0;0
RI;2020-04-29;5;3908;5;0;0;0
RI;2020-04-30;2;3910;2;0;0;0
RI;2020-05-01;1;3911;1;0;0;0
RI;2020-05-02;2;3913;1;1;0;0
RI;2020-05-03;2;3915;2;0;0;0
RI;2020-05-04;2;3917;2;0;0;0
RI;2020-05-05;0;3917;0;0;0;0
RI;2020-05-06;3;3920;3;0;0;0
RI;2020-05-07;3;3923;3;0;0;0
RI;2020-05-08;3;3926;3;0;0;0
RI;2020-05-09;2;3928;0;0;2;0
RI;2020-05-10;2;3930;2;0;0;0
RI;2020-05-11;4;3934;3;0;1;0
RI;2020-05-12;3;3937;3;0;0;0
RI;2020-05-13;5;3942;4;0;1;0
RI;2020-05-14;2;3944;2;0;0;0
RI;2020-05-15;1;3945;1;0;0;0
RI;2020-05-16;1;3946;1;0;0;0
RI;2020-05-17;0;3946;0;0;0;0
RI;2020-05-18;2;3948;2;0;0;0
RI;2020-05-19;5;3953;5;0;0;0
RI;2020-05-20;4;3957;4;0;0;0
RI;2020-05-21;4;3961;3;0;1;0
RI;2020-05-22;3;3964;3;0;0;0
RI;2020-05-23;3;3967;3;0;0;0
RI;2020-05-24;0;3967;0;0;0;0
RI;2020-05-25;2;3969;1;0;1;0
RI;2020-05-26;1;3970;1;0;0;0
RI;2020-05-27;2;3972;2;0;0;0
RI;2020-05-28;0;3972;0;0;0;0
RI;2020-05-29;2;3974;2;0;0;0
RI;2020-05-30;1;3975;1;0;0;0
RI;2020-05-31;1;3976;1;0;0;0
RI;2020-06-01;3;3979;3;0;0;0
RI;2020-06-02;0;3979;0;0;0;0
RI;2020-06-03;2;3981;2;0;0;0
RI;2020-06-04;0;3981;0;0;0;0
RI;2020-06-05;3;3984;3;0;0;0
RI;2020-06-06;1;3985;1;0;0;0
RI;2020-06-07;1;3986;1;0;0;0
RI;2020-06-08;1;3987;1;0;0;0
RI;2020-06-09;1;3988;1;0;0;0
RI;2020-06-10;0;3988;0;0;0;0
RI;2020-06-11;0;3988;0;0;0;0
RI;2020-06-12;1;3989;1;0;0;0
RI;2020-06-13;1;3990;1;0;0;0
RI;2020-06-14;0;3990;0;0;0;0
RI;2020-06-15;0;3990;0;0;0;0
RI;2020-06-16;1;3991;1;0;0;0
RI;2020-06-17;0;3991;0;0;0;0
RI;2020-06-18;1;3992;1;0;0;0
RI;2020-06-19;0;3992;0;0;0;0
RI;2020-06-20;1;3993;1;0;0;0
RI;2020-06-21;0;3993;0;0;0;0
RI;2020-06-22;0;3993;0;0;0;0
RI;2020-06-23;1;3994;1;0;0;0
RI;2020-06-24;0;3994;0;0;0;0
RI;2020-06-25;0;3994;0;0;0;0
RI;2020-06-26;0;3994;0;0;0;0
RI;2020-06-27;0;3994;0;0;0;0
RI;2020-06-28;1;3995;1;0;0;0
RI;2020-06-29;1;3996;1;0;0;0
RI;2020-06-30;0;3996;0;0;0;0
RI;2020-07-01;0;3996;0;0;0;0
RI;2020-07-02;0;3996;0;0;0;0
RI;2020-07-03;0;3996;0;0;0;0
RI;2020-07-04;0;3996;0;0;0;0
RI;2020-07-05;0;3996;0;0;0;0
VC;2020-01-31;4;4;3;1;0;0
VC;2020-02-01;1;5;1;0;0;0
VC;2020-02-02;0;5;0;0;0;0
VC;2020-02-03;5;10;1;3;0;1
VC;2020-02-04;1;11;0;1;0;0
VC;2020-02-05;3;14;0;3;0;0
VC;2020-02-06;1;15;1;0;0;0
VC;2020-02-07;1;16;0;1;0;0
VC;2020-02-08;0;16;0;0;0;0
VC;2020-02-09;0;16;0;0;0;0
VC;2020-02-10;4;20;1;3;0;0
VC;2020-02-11;1;21;1;0;0;0
VC;2020-02-12;1;22;1;0;0;0
VC;2020-02-13;2;24;1;1;0;0
VC;2020-02-14;2;26;2;0;0;0
VC;2020-02-15;4;30;4;0;0;0
VC;2020-02-16;1;31;1;0;0;0
VC;2020-02-17;5;36;2;3;0;0
VC;2020-02-18;2;38;1;1;0;0
VC;2020-02-19;2;40;1;1;0;0
VC;2020-02-20;6;46;3;3;0;0
VC;2020-02-21;3;49;2;1;0;0
VC;2020-02-22;2;51;2;0;0;0
VC;2020-02-23;5;56;5;0;0;0
VC;2020-02-24;15;71;13;2;0;0
VC;2020-02-25;10;81;8;2;0;0
VC;2020-02-26;9;90;8;1;0;0
VC;2020-02-27;15;105;15;0;0;0
VC;2020-02-28;28;133;22;5;0;1
VC;2020-02-29;17;150;14;3;0;0
VC;2020-03-01;44;194;34;9;0;1
VC;2020-03-02;46;240;36;9;0;1
VC;2020-03-03;37;277;26;9;0;2
VC;2020-03-04;37;314;33;4;0;0
VC;2020-03-05;56;370;46;8;0;2
VC;2020-03-06;78;448;66;12;0;0
VC;2020-03-07;80;528;64;8;0;8
VC;2020-03-08;118;646;99;17;0;2
VC;2020-03-09;188;834;164;21;0;3
VC;2020-03-10;306;1140;267;33;0;6
VC;2020-03-11;294;1434;263;25;0;6
VC;2020-03-12;390;1824;358;31;0;1
VC;2020-03-13;497;2321;443;45;0;9
VC;2020-03-14;496;2817;452;33;0;11
VC;2020-03-15;530;3347;467;55;0;8
VC;2020-03-16;635;3982;571;54;0;10
VC;2020-03-17;559;4541;509;39;0;11
VC;2020-03-18;532;5073;479;43;0;10
VC;2020-03-19;498;5571;459;33;0;6
VC;2020-03-20;572;6143;509;59;0;4
VC;2020-03-21;453;6596;413;32;0;8
VC;2020-03-22;397;6993;363;30;0;4
VC;2020-03-23;484;7477;430;51;0;3
VC;2020-03-24;339;7816;305;27;0;7
VC;2020-03-25;410;8226;358;42;0;10
VC;2020-03-26;311;8537;273;33;0;5
VC;2020-03-27;334;8871;296;27;0;11
VC;2020-03-28;245;9116;217;19;0;9
VC;2020-03-29;217;9333;183;23;0;11
VC;2020-03-30;254;9587;220;25;0;9
VC;2020-03-31;180;9767;150;23;0;7
VC;2020-04-01;238;10005;200;31;1;6
VC;2020-04-02;217;10222;181;31;0;5
VC;2020-04-03;215;10437;189;23;0;3
VC;2020-04-04;143;10580;119;19;0;5
VC;2020-04-05;122;10702;105;12;0;5
VC;2020-04-06;180;10882;137;37;0;6
VC;2020-04-07;171;11053;127;39;0;5
VC;2020-04-08;169;11222;124;41;0;4
VC;2020-04-09;173;11395;117;51;0;5
VC;2020-04-10;141;11536;95;45;0;1
VC;2020-04-11;133;11669;78;50;0;5
VC;2020-04-12;84;11753;68;14;0;2
VC;2020-04-13;99;11852;63;31;0;5
VC;2020-04-14;98;11950;63;29;0;6
VC;2020-04-15;151;12101;72;75;0;4
VC;2020-04-16;130;12231;52;75;0;3
VC;2020-04-17;157;12388;82;72;0;3
VC;2020-04-18;198;12586;51;142;0;5
VC;2020-04-19;71;12657;25;45;0;1
VC;2020-04-20;71;12728;34;34;0;3
VC;2020-04-21;179;12907;51;123;0;5
VC;2020-04-22;157;13064;36;120;0;1
VC;2020-04-23;191;13255;43;142;0;6
VC;2020-04-24;230;13485;40;187;0;3
VC;2020-04-25;106;13591;38;66;0;2
VC;2020-04-26;38;13629;19;18;0;1
VC;2020-04-27;51;13680;20;30;0;1
VC;2020-04-28;120;13800;37;82;0;1
VC;2020-04-29;138;13938;34;103;0;1
VC;2020-04-30;114;14052;19;94;0;1
VC;2020-05-01;94;14146;23;70;1;0
VC;2020-05-02;110;14256;31;76;0;3
VC;2020-05-03;45;14301;14;29;0;2
VC;2020-05-04;28;14329;6;21;0;1
VC;2020-05-05;29;14358;21;8;0;0
VC;2020-05-06;22;14380;19;2;0;1
VC;2020-05-07;20;14400;11;9;0;0
VC;2020-05-08;23;14423;16;7;0;0
VC;2020-05-09;17;14440;16;1;0;0
VC;2020-05-10;13;14453;13;0;0;0
VC;2020-05-11;15;14468;15;0;0;0
VC;2020-05-12;16;14484;16;0;0;0
VC;2020-05-13;15;14499;15;0;0;0
VC;2020-05-14;17;14516;17;0;0;0
VC;2020-05-15;8;14524;8;0;0;0
VC;2020-05-16;15;14539;15;0;0;0
VC;2020-05-17;7;14546;7;0;0;0
VC;2020-05-18;15;14561;15;0;0;0
VC;2020-05-19;6;14567;6;0;0;0
VC;2020-05-20;11;14578;11;0;0;0
VC;2020-05-21;14;14592;14;0;0;0
VC;2020-05-22;11;14603;11;0;0;0
VC;2020-05-23;8;14611;8;0;0;0
VC;2020-05-24;2;14613;2;0;0;0
VC;2020-05-25;5;14618;5;0;0;0
VC;2020-05-26;11;14629;11;0;0;0
VC;2020-05-27;17;14646;17;0;0;0
VC;2020-05-28;8;14654;8;0;0;0
VC;2020-05-29;7;14661;7;0;0;0
VC;2020-05-30;9;14670;9;0;0;0
VC;2020-05-31;9;14679;9;0;0;0
VC;2020-06-01;13;14692;13;0;0;0
VC;2020-06-02;10;14702;10;0;0;0
VC;2020-06-03;10;14712;10;0;0;0
VC;2020-06-04;6;14718;6;0;0;0
VC;2020-06-05;9;14727;9;0;0;0
VC;2020-06-06;11;14738;11;0;0;0
VC;2020-06-07;4;14742;4;0;0;0
VC;2020-06-08;3;14745;3;0;0;0
VC;2020-06-09;8;14753;8;0;0;0
VC;2020-06-10;6;14759;6;0;0;0
VC;2020-06-11;7;14766;7;0;0;0
VC;2020-06-12;11;14777;11;0;0;0
VC;2020-06-13;7;14784;7;0;0;0
VC;2020-06-14;4;14788;4;0;0;0
VC;2020-06-15;10;14798;10;0;0;0
VC;2020-06-16;7;14805;7;0;0;0
VC;2020-06-17;10;14815;10;0;0;0
VC;2020-06-18;1;14816;1;0;0;0
VC;2020-06-19;5;14821;5;0;0;0
VC;2020-06-20;8;14829;8;0;0;0
VC;2020-06-21;12;14841;12;0;0;0
VC;2020-06-22;12;14853;12;0;0;0
VC;2020-06-23;8;14861;8;0;0;0
VC;2020-06-24;13;14874;13;0;0;0
VC;2020-06-25;13;14887;13;0;0;0
VC;2020-06-26;16;14903;16;0;0;0
VC;2020-06-27;5;14908;5;0;0;0
VC;2020-06-28;6;14914;6;0;0;0
VC;2020-06-29;20;14934;20;0;0;0
VC;2020-06-30;5;14939;5;0;0;0
VC;2020-07-01;7;14946;7;0;0;0
VC;2020-07-02;6;14952;6;0;0;0
VC;2020-07-03;2;14954;2;0;0;0
VC;2020-07-04;0;14954;0;0;0;0
VC;2020-07-05;1;14955;1;0;0;0